Fiscal Year,County,Region,Children Receiving Adoption Subsidy,Federally Funded (Title IV-E),State Paid
2023,Anderson,4-Tyler,140,128,12
2023,Andrews,9-Midland,42,40,2
2023,Angelina,5-Beaumont,241,232,9
2023,Aransas,11-Edinburg,140,139,1
2023,Archer,2-Abilene,5,5,0
2023,Armstrong,1-Lubbock,3,3,0
2023,Atascosa,8-San Antonio,379,347,32
2023,Austin,6-Houston,24,24,0
2023,Bailey,1-Lubbock,19,19,0
2023,Bandera,8-San Antonio,98,92,6
2023,Bastrop,7-Austin,306,256,50
2023,Baylor,2-Abilene,1,1,0
2023,Bee,11-Edinburg,92,88,4
2023,Bell,7-Austin,1246,1110,136
2023,Bexar,8-San Antonio,9768,8863,905
2023,Blanco,7-Austin,30,27,3
2023,Bosque,7-Austin,70,65,5
2023,Bowie,4-Tyler,134,121,13
2023,Brazoria,6-Houston,265,253,12
2023,Brazos,7-Austin,333,306,27
2023,Brewster,10-El Paso,10,10,0
2023,Briscoe,1-Lubbock,4,4,0
2023,Brooks,11-Edinburg,17,17,0
2023,Brown,2-Abilene,271,260,11
2023,Burleson,7-Austin,51,45,6
2023,Burnet,7-Austin,226,198,28
2023,Caldwell,7-Austin,205,195,10
2023,Calhoun,8-San Antonio,24,23,1
2023,Callahan,2-Abilene,36,36,0
2023,Cameron,11-Edinburg,289,281,8
2023,Camp,4-Tyler,45,38,7
2023,Carson,1-Lubbock,20,20,0
2023,Cass,4-Tyler,62,58,4
2023,Castro,1-Lubbock,23,21,2
2023,Chambers,6-Houston,37,33,4
2023,Cherokee,4-Tyler,206,192,14
2023,Childress,1-Lubbock,24,21,3
2023,Clay,2-Abilene,11,10,1
2023,Cochran,1-Lubbock,3,2,1
2023,Coke,9-Midland,10,10,0
2023,Coleman,2-Abilene,28,28,0
2023,Collin,3-Arlington,679,629,50
2023,Collingsworth,1-Lubbock,16,16,0
2023,Colorado,6-Houston,49,48,1
2023,Comal,8-San Antonio,416,373,43
2023,Comanche,2-Abilene,35,35,0
2023,Concho,9-Midland,2,2,0
2023,Cooke,3-Arlington,135,127,8
2023,Coryell,7-Austin,211,195,16
2023,Crane,9-Midland,5,5,0
2023,Crockett,9-Midland,11,11,0
2023,Crosby,1-Lubbock,25,25,0
2023,Culberson,10-El Paso,5,5,0
2023,Dallam,1-Lubbock,27,27,0
2023,Dallas,3-Arlington,3086,2924,162
2023,Dawson,9-Midland,50,47,3
2023,DeWitt,8-San Antonio,55,49,6
2023,Deaf Smith,1-Lubbock,53,51,2
2023,Delta,4-Tyler,16,13,3
2023,Denton,3-Arlington,974,909,65
2023,Dickens,1-Lubbock,4,4,0
2023,Dimmit,8-San Antonio,61,57,4
2023,Donley,1-Lubbock,13,13,0
2023,Duval,11-Edinburg,24,23,1
2023,Eastland,2-Abilene,35,34,1
2023,Ector,9-Midland,519,481,38
2023,Edwards,8-San Antonio,4,4,0
2023,El Paso,10-El Paso,917,895,22
2023,Ellis,3-Arlington,220,208,12
2023,Erath,3-Arlington,45,44,1
2023,Falls,7-Austin,43,43,0
2023,Fannin,3-Arlington,95,90,5
2023,Fayette,7-Austin,79,70,9
2023,Fisher,2-Abilene,6,5,1
2023,Floyd,1-Lubbock,20,20,0
2023,Foard,2-Abilene,2,2,0
2023,Fort Bend,6-Houston,301,286,15
2023,Franklin,4-Tyler,26,22,4
2023,Freestone,7-Austin,37,33,4
2023,Frio,8-San Antonio,181,162,19
2023,Gaines,9-Midland,44,42,2
2023,Galveston,6-Houston,522,510,12
2023,Garza,1-Lubbock,7,6,1
2023,Gillespie,8-San Antonio,48,39,9
2023,Goliad,8-San Antonio,5,5,0
2023,Gonzales,8-San Antonio,59,55,4
2023,Gray,1-Lubbock,98,87,11
2023,Grayson,3-Arlington,314,290,24
2023,Gregg,4-Tyler,408,380,29
2023,Grimes,7-Austin,54,52,2
2023,Guadalupe,8-San Antonio,301,281,20
2023,Hale,1-Lubbock,110,107,3
2023,Hall,1-Lubbock,7,7,0
2023,Hamilton,7-Austin,19,19,0
2023,Hansford,1-Lubbock,7,7,0
2023,Hardeman,2-Abilene,5,5,0
2023,Hardin,5-Beaumont,88,81,7
2023,Harris,6-Houston,7655,7123,532
2023,Harrison,4-Tyler,131,120,11
2023,Hartley,1-Lubbock,5,5,0
2023,Haskell,2-Abilene,25,25,0
2023,Hays,7-Austin,480,453,27
2023,Hemphill,1-Lubbock,9,9,0
2023,Henderson,4-Tyler,303,266,37
2023,Hidalgo,11-Edinburg,223,223,0
2023,Hill,7-Austin,127,120,7
2023,Hockley,1-Lubbock,126,123,3
2023,Hood,3-Arlington,123,116,7
2023,Hopkins,4-Tyler,138,126,12
2023,Houston,5-Beaumont,66,66,0
2023,Howard,9-Midland,118,112,6
2023,Hudspeth,10-El Paso,1,1,0
2023,Hunt,3-Arlington,476,439,37
2023,Hutchinson,1-Lubbock,50,48,2
2023,Irion,9-Midland,3,3,0
2023,Jack,2-Abilene,4,4,0
2023,Jackson,8-San Antonio,44,43,1
2023,Jasper,5-Beaumont,140,136,4
2023,Jefferson,5-Beaumont,698,649,49
2023,Jim Hogg,11-Edinburg,7,7,0
2023,Jim Wells,11-Edinburg,83,76,7
2023,Johnson,3-Arlington,421,399,22
2023,Jones,2-Abilene,38,38,0
2023,Karnes,8-San Antonio,64,62,2
2023,Kaufman,3-Arlington,277,255,22
2023,Kendall,8-San Antonio,65,59,6
2023,Kerr,8-San Antonio,242,201,41
2023,Kimble,9-Midland,15,15,0
2023,Kinney,8-San Antonio,9,9,0
2023,Kleberg,11-Edinburg,78,74,4
2023,Knox,2-Abilene,6,6,0
2023,La Salle,8-San Antonio,32,24,8
2023,Lamar,4-Tyler,126,117,9
2023,Lamb,1-Lubbock,34,33,1
2023,Lampasas,7-Austin,76,71,5
2023,Lavaca,8-San Antonio,51,48,3
2023,Lee,7-Austin,39,38,1
2023,Leon,7-Austin,24,22,2
2023,Liberty,6-Houston,201,187,14
2023,Limestone,7-Austin,57,50,7
2023,Lipscomb,1-Lubbock,7,7,0
2023,Live Oak,11-Edinburg,31,30,1
2023,Llano,7-Austin,86,81,5
2023,Lubbock,1-Lubbock,1615,1527,88
2023,Lynn,1-Lubbock,8,8,0
2023,Madison,7-Austin,35,33,2
2023,Marion,4-Tyler,23,23,0
2023,Martin,9-Midland,1,1,0
2023,Mason,9-Midland,8,8,0
2023,Matagorda,6-Houston,39,38,1
2023,Maverick,8-San Antonio,26,24,2
2023,McCulloch,9-Midland,52,50,2
2023,McLennan,7-Austin,1210,1162,48
2023,Medina,8-San Antonio,286,259,27
2023,Menard,9-Midland,13,13,0
2023,Midland,9-Midland,275,257,18
2023,Milam,7-Austin,145,128,17
2023,Mills,7-Austin,18,18,0
2023,Mitchell,2-Abilene,4,4,0
2023,Montague,2-Abilene,67,65,2
2023,Montgomery,6-Houston,916,829,88
2023,Moore,1-Lubbock,36,30,6
2023,Morris,4-Tyler,22,21,1
2023,Motley,1-Lubbock,2,1,1
2023,Nacogdoches,5-Beaumont,250,228,22
2023,Navarro,3-Arlington,159,149,10
2023,Newton,5-Beaumont,27,24,3
2023,Nolan,2-Abilene,32,32,0
2023,None Specified,None Specified,20,20,0
2023,Nueces,11-Edinburg,651,613,38
2023,Ochiltree,1-Lubbock,9,9,0
2023,Orange,5-Beaumont,288,265,23
2023,Palo Pinto,3-Arlington,182,172,10
2023,Panola,4-Tyler,29,28,1
2023,Parker,3-Arlington,277,268,9
2023,Parmer,1-Lubbock,17,16,1
2023,Pecos,9-Midland,18,16,2
2023,Polk,5-Beaumont,99,87,12
2023,Potter,1-Lubbock,525,507,18
2023,Presidio,10-El Paso,1,1,0
2023,Rains,4-Tyler,40,39,1
2023,Randall,1-Lubbock,440,411,29
2023,Reagan,9-Midland,11,11,0
2023,Real,8-San Antonio,15,13,2
2023,Red River,4-Tyler,26,24,2
2023,Reeves,9-Midland,9,9,0
2023,Refugio,11-Edinburg,8,8,0
2023,Robertson,7-Austin,52,49,3
2023,Rockwall,3-Arlington,104,96,8
2023,Runnels,2-Abilene,26,25,1
2023,Rusk,4-Tyler,88,84,4
2023,Sabine,5-Beaumont,31,27,4
2023,San Augustine,5-Beaumont,11,10,1
2023,San Jacinto,5-Beaumont,27,26,1
2023,San Patricio,11-Edinburg,168,152,16
2023,San Saba,7-Austin,35,34,1
2023,Schleicher,9-Midland,4,4,0
2023,Scurry,2-Abilene,34,33,1
2023,Shackelford,2-Abilene,4,4,0
2023,Shelby,5-Beaumont,50,47,3
2023,Sherman,1-Lubbock,6,6,0
2023,Smith,4-Tyler,609,530,79
2023,Somervell,3-Arlington,16,13,3
2023,Starr,11-Edinburg,16,15,1
2023,Stephens,2-Abilene,16,16,0
2023,Stonewall,2-Abilene,4,4,0
2023,Sutton,9-Midland,10,10,0
2023,Swisher,1-Lubbock,30,28,2
2023,Tarrant,3-Arlington,2821,2643,178
2023,Taylor,2-Abilene,415,399,16
2023,Terry,1-Lubbock,43,41,2
2023,Throckmorton,2-Abilene,1,1,0
2023,Titus,4-Tyler,65,61,4
2023,Tom Green,9-Midland,595,576,19
2023,Travis,7-Austin,2546,2273,273
2023,Trinity,5-Beaumont,41,39,2
2023,Tyler,5-Beaumont,35,33,2
2023,Upshur,4-Tyler,119,111,8
2023,Upton,9-Midland,7,7,0
2023,Uvalde,8-San Antonio,122,110,12
2023,Val Verde,8-San Antonio,84,80,4
2023,Van Zandt,4-Tyler,231,210,21
2023,Victoria,8-San Antonio,242,222,20
2023,Walker,6-Houston,44,43,1
2023,Waller,6-Houston,85,84,1
2023,Ward,9-Midland,28,28,0
2023,Washington,7-Austin,49,48,1
2023,Webb,11-Edinburg,338,323,15
2023,Wharton,6-Houston,67,60,7
2023,Wheeler,1-Lubbock,10,10,0
2023,Wichita,2-Abilene,396,385,11
2023,Wilbarger,2-Abilene,27,26,1
2023,Willacy,11-Edinburg,39,33,6
2023,Williamson,7-Austin,784,725,60
2023,Wilson,8-San Antonio,128,108,20
2023,Winkler,9-Midland,16,14,2
2023,Wise,3-Arlington,112,112,0
2023,Wood,4-Tyler,112,96,16
2023,Yoakum,1-Lubbock,7,7,0
2023,Young,2-Abilene,67,66,1
2023,Zapata,11-Edinburg,6,6,0
2023,Zavala,8-San Antonio,55,50,5
2022,Anderson,4-Tyler,140,126,14
2022,Andrews,9-Midland,45,43,2
2022,Angelina,5-Beaumont,236,227,9
2022,Aransas,11-Edinburg,146,145,1
2022,Archer,2-Abilene,5,5,0
2022,Armstrong,1-Lubbock,1,1,0
2022,Atascosa,8-San Antonio,381,347,34
2022,Austin,6-Houston,24,24,0
2022,Bailey,1-Lubbock,21,21,0
2022,Bandera,8-San Antonio,100,93,7
2022,Bastrop,7-Austin,320,266,54
2022,Baylor,2-Abilene,1,1,0
2022,Bee,11-Edinburg,84,80,4
2022,Bell,7-Austin,1201,1058,143
2022,Bexar,8-San Antonio,9946,8977,969
2022,Blanco,7-Austin,27,24,3
2022,Bosque,7-Austin,75,70,5
2022,Bowie,4-Tyler,142,127,15
2022,Brazoria,6-Houston,264,249,15
2022,Brazos,7-Austin,316,289,27
2022,Brewster,10-El Paso,11,11,0
2022,Briscoe,1-Lubbock,4,4,0
2022,Brooks,11-Edinburg,15,15,0
2022,Brown,2-Abilene,269,257,12
2022,Burleson,7-Austin,55,49,6
2022,Burnet,7-Austin,218,185,33
2022,Caldwell,7-Austin,196,186,10
2022,Calhoun,8-San Antonio,27,26,1
2022,Callahan,2-Abilene,32,32,0
2022,Cameron,11-Edinburg,276,268,8
2022,Camp,4-Tyler,45,38,7
2022,Carson,1-Lubbock,19,19,0
2022,Cass,4-Tyler,61,55,6
2022,Castro,1-Lubbock,16,14,2
2022,Chambers,6-Houston,33,29,4
2022,Cherokee,4-Tyler,205,188,17
2022,Childress,1-Lubbock,29,23,6
2022,Clay,2-Abilene,9,8,1
2022,Cochran,1-Lubbock,3,2,1
2022,Coke,9-Midland,10,10,0
2022,Coleman,2-Abilene,25,25,0
2022,Collin,3-Arlington,644,586,58
2022,Collingsworth,1-Lubbock,16,16,0
2022,Colorado,6-Houston,50,48,2
2022,Comal,8-San Antonio,417,374,43
2022,Comanche,2-Abilene,35,35,0
2022,Concho,9-Midland,4,4,0
2022,Cooke,3-Arlington,130,122,8
2022,Coryell,7-Austin,207,192,15
2022,Crane,9-Midland,5,5,0
2022,Crockett,9-Midland,9,9,0
2022,Crosby,1-Lubbock,26,26,0
2022,Culberson,10-El Paso,5,5,0
2022,Dallam,1-Lubbock,26,26,0
2022,Dallas,3-Arlington,3197,3009,189
2022,Dawson,9-Midland,52,49,3
2022,DeWitt,8-San Antonio,62,56,6
2022,Deaf Smith,1-Lubbock,61,59,2
2022,Delta,4-Tyler,16,13,3
2022,Denton,3-Arlington,935,864,71
2022,Dickens,1-Lubbock,4,4,0
2022,Dimmit,8-San Antonio,64,60,4
2022,Donley,1-Lubbock,16,16,0
2022,Duval,11-Edinburg,24,23,1
2022,Eastland,2-Abilene,33,32,1
2022,Ector,9-Midland,518,477,41
2022,Edwards,8-San Antonio,5,5,0
2022,El Paso,10-El Paso,935,909,26
2022,Ellis,3-Arlington,197,182,15
2022,Erath,3-Arlington,48,47,1
2022,Falls,7-Austin,40,40,0
2022,Fannin,3-Arlington,102,94,8
2022,Fayette,7-Austin,76,64,12
2022,Fisher,2-Abilene,6,5,1
2022,Floyd,1-Lubbock,22,21,1
2022,Foard,2-Abilene,2,2,0
2022,Fort Bend,6-Houston,300,282,18
2022,Franklin,4-Tyler,23,19,4
2022,Freestone,7-Austin,33,29,4
2022,Frio,8-San Antonio,185,165,20
2022,Gaines,9-Midland,43,40,3
2022,Galveston,6-Houston,528,511,17
2022,Garza,1-Lubbock,10,9,1
2022,Gillespie,8-San Antonio,54,44,10
2022,Goliad,8-San Antonio,4,4,0
2022,Gonzales,8-San Antonio,66,62,4
2022,Gray,1-Lubbock,94,81,13
2022,Grayson,3-Arlington,307,279,28
2022,Gregg,4-Tyler,422,387,35
2022,Grimes,7-Austin,53,50,3
2022,Guadalupe,8-San Antonio,312,291,21
2022,Hale,1-Lubbock,117,114,3
2022,Hall,1-Lubbock,9,9,0
2022,Hamilton,7-Austin,16,16,0
2022,Hansford,1-Lubbock,7,7,0
2022,Hardeman,2-Abilene,3,3,0
2022,Hardin,5-Beaumont,90,82,8
2022,Harris,6-Houston,8061,7462,599
2022,Harrison,4-Tyler,124,113,11
2022,Hartley,1-Lubbock,7,7,0
2022,Haskell,2-Abilene,24,24,0
2022,Hays,7-Austin,411,384,27
2022,Hemphill,1-Lubbock,9,9,0
2022,Henderson,4-Tyler,302,265,37
2022,Hidalgo,11-Edinburg,208,208,0
2022,Hill,7-Austin,123,112,11
2022,Hockley,1-Lubbock,126,121,5
2022,Hood,3-Arlington,116,108,8
2022,Hopkins,4-Tyler,137,125,12
2022,Houston,5-Beaumont,61,61,0
2022,Howard,9-Midland,115,109,6
2022,Hudspeth,10-El Paso,1,1,0
2022,Hunt,3-Arlington,483,443,40
2022,Hutchinson,1-Lubbock,53,51,2
2022,Irion,9-Midland,3,3,0
2022,Jack,2-Abilene,3,3,0
2022,Jackson,8-San Antonio,45,44,1
2022,Jasper,5-Beaumont,125,121,4
2022,Jefferson,5-Beaumont,663,610,53
2022,Jim Hogg,11-Edinburg,6,6,0
2022,Jim Wells,11-Edinburg,86,79,7
2022,Johnson,3-Arlington,429,404,25
2022,Jones,2-Abilene,29,29,0
2022,Karnes,8-San Antonio,62,60,2
2022,Kaufman,3-Arlington,267,238,29
2022,Kendall,8-San Antonio,70,63,7
2022,Kerr,8-San Antonio,262,222,40
2022,Kimble,9-Midland,17,16,1
2022,Kinney,8-San Antonio,8,8,0
2022,Kleberg,11-Edinburg,72,67,5
2022,Knox,2-Abilene,6,6,0
2022,La Salle,8-San Antonio,35,27,8
2022,Lamar,4-Tyler,121,111,10
2022,Lamb,1-Lubbock,35,34,1
2022,Lampasas,7-Austin,74,69,5
2022,Lavaca,8-San Antonio,52,49,3
2022,Lee,7-Austin,37,36,1
2022,Leon,7-Austin,25,23,2
2022,Liberty,6-Houston,209,191,18
2022,Limestone,7-Austin,61,54,7
2022,Lipscomb,1-Lubbock,7,7,0
2022,Live Oak,11-Edinburg,33,32,1
2022,Llano,7-Austin,84,78,7
2022,Lubbock,1-Lubbock,1667,1567,100
2022,Lynn,1-Lubbock,8,8,0
2022,Madison,7-Austin,30,28,2
2022,Marion,4-Tyler,19,19,0
2022,Martin,9-Midland,1,1,0
2022,Mason,9-Midland,9,9,0
2022,Matagorda,6-Houston,41,40,1
2022,Maverick,8-San Antonio,24,22,2
2022,McCulloch,9-Midland,42,40,2
2022,McLennan,7-Austin,1213,1161,52
2022,Medina,8-San Antonio,290,260,30
2022,Menard,9-Midland,11,11,0
2022,Midland,9-Midland,266,245,21
2022,Milam,7-Austin,133,115,18
2022,Mills,7-Austin,12,12,0
2022,Mitchell,2-Abilene,3,3,0
2022,Montague,2-Abilene,57,54,3
2022,Montgomery,6-Houston,929,830,99
2022,Moore,1-Lubbock,31,25,6
2022,Morris,4-Tyler,22,21,1
2022,Motley,1-Lubbock,2,1,1
2022,Nacogdoches,5-Beaumont,243,217,26
2022,Navarro,3-Arlington,171,158,13
2022,Newton,5-Beaumont,26,23,3
2022,Nolan,2-Abilene,34,34,0
2022,None Specified,None Specified,17,17,0
2022,Nueces,11-Edinburg,624,584,40
2022,Ochiltree,1-Lubbock,9,9,0
2022,Orange,5-Beaumont,279,254,25
2022,Palo Pinto,3-Arlington,175,165,10
2022,Panola,4-Tyler,25,24,1
2022,Parker,3-Arlington,275,263,12
2022,Parmer,1-Lubbock,18,17,1
2022,Pecos,9-Midland,27,25,2
2022,Polk,5-Beaumont,92,80,12
2022,Potter,1-Lubbock,529,510,19
2022,Presidio,10-El Paso,1,1,0
2022,Rains,4-Tyler,40,39,1
2022,Randall,1-Lubbock,437,405,32
2022,Reagan,9-Midland,12,12,0
2022,Real,8-San Antonio,15,13,2
2022,Red River,4-Tyler,27,25,2
2022,Reeves,9-Midland,17,17,0
2022,Refugio,11-Edinburg,8,8,0
2022,Robertson,7-Austin,51,48,3
2022,Rockwall,3-Arlington,102,94,8
2022,Runnels,2-Abilene,26,25,1
2022,Rusk,4-Tyler,86,83,3
2022,Sabine,5-Beaumont,26,22,4
2022,San Augustine,5-Beaumont,11,10,1
2022,San Jacinto,5-Beaumont,27,26,1
2022,San Patricio,11-Edinburg,168,151,17
2022,San Saba,7-Austin,37,36,1
2022,Schleicher,9-Midland,4,4,0
2022,Scurry,2-Abilene,31,30,1
2022,Shackelford,2-Abilene,4,4,0
2022,Shelby,5-Beaumont,48,45,3
2022,Sherman,1-Lubbock,7,6,1
2022,Smith,4-Tyler,583,498,85
2022,Somervell,3-Arlington,15,12,3
2022,Starr,11-Edinburg,19,18,1
2022,Stephens,2-Abilene,14,14,0
2022,Stonewall,2-Abilene,4,4,0
2022,Sutton,9-Midland,8,8,0
2022,Swisher,1-Lubbock,33,31,2
2022,Tarrant,3-Arlington,2821,2618,203
2022,Taylor,2-Abilene,388,369,19
2022,Terry,1-Lubbock,47,43,4
2022,Titus,4-Tyler,69,64,5
2022,Tom Green,9-Midland,586,567,19
2022,Travis,7-Austin,2602,2311,291
2022,Trinity,5-Beaumont,36,34,2
2022,Tyler,5-Beaumont,33,31,2
2022,Upshur,4-Tyler,118,109,9
2022,Upton,9-Midland,7,7,0
2022,Uvalde,8-San Antonio,127,113,14
2022,Val Verde,8-San Antonio,77,73,4
2022,Van Zandt,4-Tyler,220,199,21
2022,Victoria,8-San Antonio,264,240,24
2022,Walker,6-Houston,52,51,1
2022,Waller,6-Houston,86,84,2
2022,Ward,9-Midland,24,24,0
2022,Washington,7-Austin,52,50,2
2022,Webb,11-Edinburg,345,329,16
2022,Wharton,6-Houston,65,57,8
2022,Wheeler,1-Lubbock,10,10,0
2022,Wichita,2-Abilene,362,349,13
2022,Wilbarger,2-Abilene,24,23,1
2022,Willacy,11-Edinburg,39,33,6
2022,Williamson,7-Austin,778,711,67
2022,Wilson,8-San Antonio,129,105,24
2022,Winkler,9-Midland,22,20,2
2022,Wise,3-Arlington,113,112,2
2022,Wood,4-Tyler,118,100,18
2022,Yoakum,1-Lubbock,9,9,0
2022,Young,2-Abilene,62,61,1
2022,Zapata,11-Edinburg,6,6,0
2022,Zavala,8-San Antonio,55,50,5
2021,Anderson,4-Tyler,113,97,16
2021,Andrews,9-Midland,38,36,2
2021,Angelina,5-Beaumont,222,213,9
2021,Aransas,11-Edinburg,136,135,1
2021,Archer,2-Abilene,2,2,0
2021,Armstrong,1-Lubbock,1,1,0
2021,Atascosa,8-San Antonio,380,341,39
2021,Austin,6-Houston,25,24,1
2021,Bailey,1-Lubbock,21,21,0
2021,Bandera,8-San Antonio,100,92,8
2021,Bastrop,7-Austin,317,260,57
2021,Baylor,2-Abilene,2,1,1
2021,Bee,11-Edinburg,85,81,4
2021,Bell,7-Austin,1132,979,153
2021,Bexar,8-San Antonio,10065,9031,1034
2021,Blanco,7-Austin,27,24,3
2021,Bosque,7-Austin,74,68,6
2021,Bowie,4-Tyler,152,134,18
2021,Brazoria,6-Houston,260,239,21
2021,Brazos,7-Austin,312,284,28
2021,Brewster,10-El Paso,11,11,0
2021,Briscoe,1-Lubbock,1,1,0
2021,Brooks,11-Edinburg,15,15,0
2021,Brown,2-Abilene,262,248,14
2021,Burleson,7-Austin,51,45,6
2021,Burnet,7-Austin,217,182,35
2021,Caldwell,7-Austin,186,175,11
2021,Calhoun,8-San Antonio,22,21,1
2021,Callahan,2-Abilene,29,29,0
2021,Cameron,11-Edinburg,258,250,8
2021,Camp,4-Tyler,46,37,9
2021,Carson,1-Lubbock,21,21,0
2021,Cass,4-Tyler,60,52,8
2021,Castro,1-Lubbock,18,16,2
2021,Chambers,6-Houston,32,28,4
2021,Cherokee,4-Tyler,201,184,17
2021,Childress,1-Lubbock,30,24,6
2021,Clay,2-Abilene,10,8,2
2021,Cochran,1-Lubbock,4,2,2
2021,Coke,9-Midland,13,13,0
2021,Coleman,2-Abilene,26,26,0
2021,Collin,3-Arlington,636,572,64
2021,Collingsworth,1-Lubbock,16,16,0
2021,Colorado,6-Houston,47,45,2
2021,Comal,8-San Antonio,401,357,44
2021,Comanche,2-Abilene,33,33,0
2021,Concho,9-Midland,4,4,0
2021,Cooke,3-Arlington,133,122,11
2021,Coryell,7-Austin,187,172,15
2021,Crane,9-Midland,4,4,0
2021,Crockett,9-Midland,8,8,0
2021,Crosby,1-Lubbock,28,28,0
2021,Culberson,10-El Paso,5,5,0
2021,Dallam,1-Lubbock,19,19,0
2021,Dallas,3-Arlington,3276,3063,213
2021,Dawson,9-Midland,51,48,3
2021,DeWitt,8-San Antonio,61,55,6
2021,Deaf Smith,1-Lubbock,59,57,2
2021,Delta,4-Tyler,19,16,3
2021,Denton,3-Arlington,907,823,84
2021,Dickens,1-Lubbock,4,4,0
2021,Dimmit,8-San Antonio,62,58,4
2021,Donley,1-Lubbock,19,19,0
2021,Duval,11-Edinburg,15,14,1
2021,Eastland,2-Abilene,31,29,2
2021,Ector,9-Midland,490,449,41
2021,Edwards,8-San Antonio,5,5,0
2021,El Paso,10-El Paso,961,932,29
2021,Ellis,3-Arlington,196,180,16
2021,Erath,3-Arlington,46,45,1
2021,Falls,7-Austin,42,42,0
2021,Fannin,3-Arlington,97,88,9
2021,Fayette,7-Austin,77,65,12
2021,Fisher,2-Abilene,6,5,1
2021,Floyd,1-Lubbock,25,24,1
2021,Foard,2-Abilene,2,2,0
2021,Fort Bend,6-Houston,298,274,24
2021,Franklin,4-Tyler,21,17,4
2021,Freestone,7-Austin,35,31,4
2021,Frio,8-San Antonio,181,160,21
2021,Gaines,9-Midland,42,39,3
2021,Galveston,6-Houston,512,491,21
2021,Garza,1-Lubbock,9,8,1
2021,Gillespie,8-San Antonio,54,43,11
2021,Goliad,8-San Antonio,5,5,0
2021,Gonzales,8-San Antonio,70,66,4
2021,Gray,1-Lubbock,99,86,13
2021,Grayson,3-Arlington,311,281,30
2021,Gregg,4-Tyler,410,371,39
2021,Grimes,7-Austin,54,51,3
2021,Guadalupe,8-San Antonio,319,298,21
2021,Hale,1-Lubbock,115,111,4
2021,Hall,1-Lubbock,8,7,1
2021,Hamilton,7-Austin,16,16,0
2021,Hansford,1-Lubbock,9,9,0
2021,Hardeman,2-Abilene,3,3,0
2021,Hardin,5-Beaumont,81,72,9
2021,Harris,6-Houston,8406,7737,671
2021,Harrison,4-Tyler,130,115,15
2021,Hartley,1-Lubbock,7,7,0
2021,Haskell,2-Abilene,24,24,0
2021,Hays,7-Austin,388,359,29
2021,Hemphill,1-Lubbock,10,10,0
2021,Henderson,4-Tyler,283,245,38
2021,Hidalgo,11-Edinburg,196,196,0
2021,Hill,7-Austin,124,111,14
2021,Hockley,1-Lubbock,127,121,6
2021,Hood,3-Arlington,110,102,8
2021,Hopkins,4-Tyler,131,119,12
2021,Houston,5-Beaumont,58,58,0
2021,Howard,9-Midland,112,106,6
2021,Hudspeth,10-El Paso,1,1,0
2021,Hunt,3-Arlington,472,430,42
2021,Hutchinson,1-Lubbock,54,52,2
2021,Jack,2-Abilene,5,5,0
2021,Jackson,8-San Antonio,37,36,1
2021,Jasper,5-Beaumont,117,111,6
2021,Jefferson,5-Beaumont,642,586,56
2021,Jim Hogg,11-Edinburg,6,6,0
2021,Jim Wells,11-Edinburg,87,80,7
2021,Johnson,3-Arlington,434,408,26
2021,Jones,2-Abilene,29,29,0
2021,Karnes,8-San Antonio,58,57,1
2021,Kaufman,3-Arlington,270,239,31
2021,Kendall,8-San Antonio,67,59,8
2021,Kerr,8-San Antonio,263,222,41
2021,Kimble,9-Midland,15,14,1
2021,Kinney,8-San Antonio,7,7,0
2021,Kleberg,11-Edinburg,74,69,5
2021,Knox,2-Abilene,3,3,0
2021,La Salle,8-San Antonio,34,26,8
2021,Lamar,4-Tyler,99,88,11
2021,Lamb,1-Lubbock,40,39,1
2021,Lampasas,7-Austin,65,60,5
2021,Lavaca,8-San Antonio,55,52,3
2021,Lee,7-Austin,32,31,1
2021,Leon,7-Austin,26,24,2
2021,Liberty,6-Houston,213,193,20
2021,Limestone,7-Austin,61,53,8
2021,Lipscomb,1-Lubbock,9,9,0
2021,Live Oak,11-Edinburg,33,32,1
2021,Llano,7-Austin,77,70,7
2021,Lubbock,1-Lubbock,1719,1610,109
2021,Lynn,1-Lubbock,9,9,0
2021,Madison,7-Austin,29,27,2
2021,Marion,4-Tyler,16,16,0
2021,Mason,9-Midland,10,10,0
2021,Matagorda,6-Houston,48,47,1
2021,Maverick,8-San Antonio,25,23,2
2021,McCulloch,9-Midland,36,34,2
2021,McLennan,7-Austin,1147,1087,60
2021,Medina,8-San Antonio,300,267,33
2021,Menard,9-Midland,9,9,0
2021,Midland,9-Midland,270,246,24
2021,Milam,7-Austin,130,111,19
2021,Mills,7-Austin,13,13,0
2021,Mitchell,2-Abilene,3,3,0
2021,Montague,2-Abilene,53,49,4
2021,Montgomery,6-Houston,954,844,110
2021,Moore,1-Lubbock,27,21,6
2021,Morris,4-Tyler,22,21,1
2021,Motley,1-Lubbock,2,1,1
2021,Nacogdoches,5-Beaumont,218,193,25
2021,Navarro,3-Arlington,167,153,14
2021,Newton,5-Beaumont,26,23,3
2021,Nolan,2-Abilene,39,39,0
2021,None Specified,None Specified,22,20,2
2021,Nueces,11-Edinburg,610,564,46
2021,Ochiltree,1-Lubbock,7,7,0
2021,Oldham,1-Lubbock,4,4,0
2021,Orange,5-Beaumont,250,225,25
2021,Palo Pinto,3-Arlington,163,154,9
2021,Panola,4-Tyler,24,23,1
2021,Parker,3-Arlington,251,238,13
2021,Parmer,1-Lubbock,20,18,2
2021,Pecos,9-Midland,19,17,2
2021,Polk,5-Beaumont,102,89,13
2021,Potter,1-Lubbock,504,484,20
2021,Presidio,10-El Paso,1,1,0
2021,Rains,4-Tyler,35,33,2
2021,Randall,1-Lubbock,449,413,36
2021,Reagan,9-Midland,10,10,0
2021,Real,8-San Antonio,15,13,2
2021,Red River,4-Tyler,25,23,2
2021,Reeves,9-Midland,13,13,0
2021,Refugio,11-Edinburg,8,8,0
2021,Robertson,7-Austin,53,50,3
2021,Rockwall,3-Arlington,90,81,9
2021,Runnels,2-Abilene,26,25,1
2021,Rusk,4-Tyler,84,79,5
2021,Sabine,5-Beaumont,24,20,4
2021,San Augustine,5-Beaumont,13,12,1
2021,San Jacinto,5-Beaumont,24,23,1
2021,San Patricio,11-Edinburg,172,153,19
2021,San Saba,7-Austin,40,39,1
2021,Schleicher,9-Midland,6,6,0
2021,Scurry,2-Abilene,34,33,1
2021,Shackelford,2-Abilene,4,4,0
2021,Shelby,5-Beaumont,48,45,3
2021,Sherman,1-Lubbock,8,6,2
2021,Smith,4-Tyler,573,484,89
2021,Somervell,3-Arlington,18,15,3
2021,Starr,11-Edinburg,21,20,1
2021,Stephens,2-Abilene,13,13,0
2021,Stonewall,2-Abilene,5,5,0
2021,Sutton,9-Midland,8,8,0
2021,Swisher,1-Lubbock,31,29,2
2021,Tarrant,3-Arlington,2797,2569,228
2021,Taylor,2-Abilene,344,325,19
2021,Terry,1-Lubbock,41,36,5
2021,Titus,4-Tyler,72,66,6
2021,Tom Green,9-Midland,594,571,23
2021,Travis,7-Austin,2603,2277,326
2021,Trinity,5-Beaumont,38,36,2
2021,Tyler,5-Beaumont,28,26,2
2021,Upshur,4-Tyler,100,91,9
2021,Upton,9-Midland,6,6,0
2021,Uvalde,8-San Antonio,141,124,17
2021,Val Verde,8-San Antonio,75,71,4
2021,Van Zandt,4-Tyler,220,197,23
2021,Victoria,8-San Antonio,252,227,25
2021,Walker,6-Houston,53,51,2
2021,Waller,6-Houston,88,86,2
2021,Ward,9-Midland,16,16,0
2021,Washington,7-Austin,51,48,3
2021,Webb,11-Edinburg,350,333,17
2021,Wharton,6-Houston,71,63,8
2021,Wheeler,1-Lubbock,12,12,0
2021,Wichita,2-Abilene,353,337,16
2021,Wilbarger,2-Abilene,20,19,1
2021,Willacy,11-Edinburg,41,35,6
2021,Williamson,7-Austin,774,699,75
2021,Wilson,8-San Antonio,127,103,24
2021,Winkler,9-Midland,24,21,3
2021,Wise,3-Arlington,107,104,3
2021,Wood,4-Tyler,118,99,19
2021,Yoakum,1-Lubbock,10,9,1
2021,Young,2-Abilene,60,58,2
2021,Zapata,11-Edinburg,6,6,0
2021,Zavala,8-San Antonio,57,52,5
2020,Anderson,4-Tyler,107,90,17
2020,Andrews,9-Midland,32,30,2
2020,Angelina,5-Beaumont,196,183,13
2020,Aransas,11-Edinburg,124,122,2
2020,Archer,2-Abilene,3,3,0
2020,Armstrong,1-Lubbock,1,1,0
2020,Atascosa,8-San Antonio,367,326,41
2020,Austin,6-Houston,25,23,2
2020,Bailey,1-Lubbock,17,17,0
2020,Bandera,8-San Antonio,96,88,8
2020,Bastrop,7-Austin,323,263,60
2020,Baylor,2-Abilene,5,4,1
2020,Bee,11-Edinburg,76,72,4
2020,Bell,7-Austin,1077,918,159
2020,Bexar,8-San Antonio,10133,9026,1107
2020,Blanco,7-Austin,29,26,3
2020,Bosque,7-Austin,63,57,6
2020,Bowie,4-Tyler,161,139,22
2020,Brazoria,6-Houston,258,231,27
2020,Brazos,7-Austin,301,271,30
2020,Brewster,10-El Paso,10,10,0
2020,Brooks,11-Edinburg,17,17,0
2020,Brown,2-Abilene,269,251,18
2020,Burleson,7-Austin,52,46,6
2020,Burnet,7-Austin,228,191,37
2020,Caldwell,7-Austin,183,172,11
2020,Calhoun,8-San Antonio,25,23,2
2020,Callahan,2-Abilene,24,24,0
2020,Cameron,11-Edinburg,249,239,10
2020,Camp,4-Tyler,41,32,9
2020,Carson,1-Lubbock,19,19,0
2020,Cass,4-Tyler,58,49,9
2020,Castro,1-Lubbock,16,14,2
2020,Chambers,6-Houston,31,27,4
2020,Cherokee,4-Tyler,190,172,18
2020,Childress,1-Lubbock,28,22,6
2020,Clay,2-Abilene,9,7,2
2020,Cochran,1-Lubbock,6,4,2
2020,Coke,9-Midland,10,10,0
2020,Coleman,2-Abilene,28,27,1
2020,Collin,3-Arlington,627,553,74
2020,Collingsworth,1-Lubbock,18,17,1
2020,Colorado,6-Houston,54,50,4
2020,Comal,8-San Antonio,395,350,46
2020,Comanche,2-Abilene,28,28,0
2020,Concho,9-Midland,5,5,0
2020,Cooke,3-Arlington,132,121,11
2020,Coryell,7-Austin,144,129,15
2020,Crane,9-Midland,4,4,0
2020,Crockett,9-Midland,8,8,0
2020,Crosby,1-Lubbock,33,33,0
2020,Culberson,10-El Paso,3,3,0
2020,Dallam,1-Lubbock,24,23,1
2020,Dallas,3-Arlington,3358,3097,261
2020,Dawson,9-Midland,48,45,3
2020,DeWitt,8-San Antonio,61,55,6
2020,Deaf Smith,1-Lubbock,62,60,2
2020,Delta,4-Tyler,19,16,3
2020,Denton,3-Arlington,887,782,105
2020,Dickens,1-Lubbock,5,5,0
2020,Dimmit,8-San Antonio,62,58,4
2020,Donley,1-Lubbock,18,18,0
2020,Duval,11-Edinburg,15,14,1
2020,Eastland,2-Abilene,28,26,2
2020,Ector,9-Midland,439,395,44
2020,Edwards,8-San Antonio,6,6,0
2020,El Paso,10-El Paso,1001,958,43
2020,Ellis,3-Arlington,193,175,18
2020,Erath,3-Arlington,46,45,1
2020,Falls,7-Austin,29,29,0
2020,Fannin,3-Arlington,81,71,10
2020,Fayette,7-Austin,79,67,12
2020,Fisher,2-Abilene,6,5,1
2020,Floyd,1-Lubbock,28,27,1
2020,Foard,2-Abilene,2,2,0
2020,Fort Bend,6-Houston,283,254,29
2020,Franklin,4-Tyler,19,15,4
2020,Freestone,7-Austin,34,30,4
2020,Frio,8-San Antonio,170,149,21
2020,Gaines,9-Midland,31,27,4
2020,Galveston,6-Houston,516,489,27
2020,Garza,1-Lubbock,9,8,1
2020,Gillespie,8-San Antonio,57,45,12
2020,Goliad,8-San Antonio,5,5,0
2020,Gonzales,8-San Antonio,73,69,4
2020,Gray,1-Lubbock,103,90,13
2020,Grayson,3-Arlington,305,271,34
2020,Gregg,4-Tyler,400,353,47
2020,Grimes,7-Austin,53,50,3
2020,Guadalupe,8-San Antonio,321,297,24
2020,Hale,1-Lubbock,112,108,4
2020,Hall,1-Lubbock,10,9,1
2020,Hamilton,7-Austin,17,17,0
2020,Hansford,1-Lubbock,10,10,0
2020,Hardeman,2-Abilene,3,3,0
2020,Hardin,5-Beaumont,75,64,11
2020,Harris,6-Houston,8716,7959,758
2020,Harrison,4-Tyler,118,99,19
2020,Hartley,1-Lubbock,9,8,1
2020,Haskell,2-Abilene,21,21,0
2020,Hays,7-Austin,378,346,32
2020,Hemphill,1-Lubbock,10,10,0
2020,Henderson,4-Tyler,276,236,40
2020,Hidalgo,11-Edinburg,173,173,0
2020,Hill,7-Austin,118,102,16
2020,Hockley,1-Lubbock,130,120,10
2020,Hood,3-Arlington,111,100,11
2020,Hopkins,4-Tyler,128,114,14
2020,Houston,5-Beaumont,57,56,1
2020,Howard,9-Midland,118,112,6
2020,Hudspeth,10-El Paso,1,1,0
2020,Hunt,3-Arlington,480,436,44
2020,Hutchinson,1-Lubbock,54,51,3
2020,Jack,2-Abilene,3,3,0
2020,Jackson,8-San Antonio,34,33,1
2020,Jasper,5-Beaumont,111,105,6
2020,Jefferson,5-Beaumont,632,569,63
2020,Jim Hogg,11-Edinburg,9,9,0
2020,Jim Wells,11-Edinburg,84,76,8
2020,Johnson,3-Arlington,438,408,30
2020,Jones,2-Abilene,28,28,0
2020,Karnes,8-San Antonio,57,57,0
2020,Kaufman,3-Arlington,262,230,32
2020,Kendall,8-San Antonio,68,60,8
2020,Kerr,8-San Antonio,270,227,43
2020,Kimble,9-Midland,19,18,1
2020,Kinney,8-San Antonio,3,3,0
2020,Kleberg,11-Edinburg,80,75,5
2020,Knox,2-Abilene,3,3,0
2020,La Salle,8-San Antonio,33,25,8
2020,Lamar,4-Tyler,86,75,11
2020,Lamb,1-Lubbock,44,42,2
2020,Lampasas,7-Austin,60,55,5
2020,Lavaca,8-San Antonio,53,50,3
2020,Lee,7-Austin,33,31,2
2020,Leon,7-Austin,24,22,2
2020,Liberty,6-Houston,212,188,24
2020,Limestone,7-Austin,58,50,8
2020,Lipscomb,1-Lubbock,7,7,0
2020,Live Oak,11-Edinburg,33,32,1
2020,Llano,7-Austin,77,70,7
2020,Lubbock,1-Lubbock,1726,1603,123
2020,Lynn,1-Lubbock,10,10,0
2020,Madison,7-Austin,28,26,2
2020,Marion,4-Tyler,14,13,1
2020,Mason,9-Midland,3,3,0
2020,Matagorda,6-Houston,51,49,2
2020,Maverick,8-San Antonio,24,22,2
2020,McCulloch,9-Midland,30,28,2
2020,McLennan,7-Austin,1102,1040,62
2020,Medina,8-San Antonio,286,251,35
2020,Menard,9-Midland,7,7,0
2020,Midland,9-Midland,266,242,24
2020,Milam,7-Austin,135,116,19
2020,Mills,7-Austin,11,11,0
2020,Mitchell,2-Abilene,4,3,1
2020,Montague,2-Abilene,55,50,5
2020,Montgomery,6-Houston,984,855,129
2020,Moore,1-Lubbock,30,23,7
2020,Morris,4-Tyler,17,16,1
2020,Motley,1-Lubbock,2,1,1
2020,Nacogdoches,5-Beaumont,217,191,26
2020,Navarro,3-Arlington,163,146,17
2020,Newton,5-Beaumont,28,25,3
2020,Nolan,2-Abilene,36,36,0
2020,None Specified,None Specified,29,27,2
2020,Nueces,11-Edinburg,624,574,50
2020,Ochiltree,1-Lubbock,7,7,0
2020,Oldham,1-Lubbock,2,2,0
2020,Orange,5-Beaumont,221,192,29
2020,Palo Pinto,3-Arlington,164,154,10
2020,Panola,4-Tyler,23,22,1
2020,Parker,3-Arlington,257,243,14
2020,Parmer,1-Lubbock,19,17,2
2020,Pecos,9-Midland,20,18,2
2020,Polk,5-Beaumont,95,81,14
2020,Potter,1-Lubbock,477,452,25
2020,Presidio,10-El Paso,3,3,0
2020,Rains,4-Tyler,35,32,3
2020,Randall,1-Lubbock,458,418,40
2020,Reagan,9-Midland,10,10,0
2020,Real,8-San Antonio,15,13,2
2020,Red River,4-Tyler,25,23,2
2020,Reeves,9-Midland,15,15,0
2020,Refugio,11-Edinburg,2,2,0
2020,Robertson,7-Austin,53,50,3
2020,Rockwall,3-Arlington,82,73,9
2020,Runnels,2-Abilene,22,21,1
2020,Rusk,4-Tyler,76,71,5
2020,Sabine,5-Beaumont,24,20,4
2020,San Augustine,5-Beaumont,11,10,1
2020,San Jacinto,5-Beaumont,22,20,2
2020,San Patricio,11-Edinburg,164,142,22
2020,San Saba,7-Austin,33,31,2
2020,Schleicher,9-Midland,6,6,0
2020,Scurry,2-Abilene,30,29,1
2020,Shackelford,2-Abilene,4,4,0
2020,Shelby,5-Beaumont,47,44,3
2020,Sherman,1-Lubbock,10,8,2
2020,Smith,4-Tyler,568,470,98
2020,Somervell,3-Arlington,14,11,3
2020,Starr,11-Edinburg,21,20,1
2020,Stephens,2-Abilene,16,16,0
2020,Stonewall,2-Abilene,5,5,0
2020,Sutton,9-Midland,8,8,0
2020,Swisher,1-Lubbock,30,28,2
2020,Tarrant,3-Arlington,2763,2511,253
2020,Taylor,2-Abilene,320,300,20
2020,Terry,1-Lubbock,44,39,5
2020,Titus,4-Tyler,63,55,8
2020,Tom Green,9-Midland,571,544,27
2020,Travis,7-Austin,2610,2253,357
2020,Trinity,5-Beaumont,37,34,3
2020,Tyler,5-Beaumont,27,24,3
2020,Upshur,4-Tyler,82,73,9
2020,Upton,9-Midland,6,6,0
2020,Uvalde,8-San Antonio,130,111,19
2020,Val Verde,8-San Antonio,62,58,4
2020,Van Zandt,4-Tyler,209,185,24
2020,Victoria,8-San Antonio,230,202,28
2020,Walker,6-Houston,56,54,2
2020,Waller,6-Houston,88,86,2
2020,Ward,9-Midland,11,11,0
2020,Washington,7-Austin,64,61,3
2020,Webb,11-Edinburg,366,345,21
2020,Wharton,6-Houston,75,67,8
2020,Wheeler,1-Lubbock,12,12,0
2020,Wichita,2-Abilene,357,335,22
2020,Wilbarger,2-Abilene,21,20,1
2020,Willacy,11-Edinburg,42,34,8
2020,Williamson,7-Austin,748,667,83
2020,Wilson,8-San Antonio,129,104,25
2020,Winkler,9-Midland,16,13,3
2020,Wise,3-Arlington,100,97,3
2020,Wood,4-Tyler,120,99,21
2020,Yoakum,1-Lubbock,11,10,1
2020,Young,2-Abilene,56,54,2
2020,Zapata,11-Edinburg,6,6,0
2020,Zavala,8-San Antonio,49,44,5
2019,Anderson,4-Tyler,104,84,20
2019,Andrews,9-Midland,31,29,2
2019,Angelina,5-Beaumont,179,162,17
2019,Aransas,11-Edinburg,103,101,2
2019,Archer,2-Abilene,2,2,0
2019,Armstrong,1-Lubbock,4,4,0
2019,Atascosa,8-San Antonio,359,317,42
2019,Austin,6-Houston,28,26,2
2019,Bailey,1-Lubbock,18,18,0
2019,Bandera,8-San Antonio,91,83,8
2019,Bastrop,7-Austin,319,257,62
2019,Baylor,2-Abilene,7,6,1
2019,Bee,11-Edinburg,76,72,4
2019,Bell,7-Austin,1002,839,163
2019,Bexar,8-San Antonio,9932,8750,1184
2019,Blanco,7-Austin,24,21,3
2019,Bosque,7-Austin,61,56,5
2019,Bowie,4-Tyler,170,143,28
2019,Brazoria,6-Houston,237,207,30
2019,Brazos,7-Austin,291,259,32
2019,Brewster,10-El Paso,10,10,0
2019,Brooks,11-Edinburg,17,17,0
2019,Brown,2-Abilene,261,239,22
2019,Burleson,7-Austin,46,42,4
2019,Burnet,7-Austin,220,182,38
2019,Caldwell,7-Austin,186,174,12
2019,Calhoun,8-San Antonio,24,20,4
2019,Callahan,2-Abilene,20,20,0
2019,Cameron,11-Edinburg,251,240,11
2019,Camp,4-Tyler,42,33,9
2019,Carson,1-Lubbock,17,17,0
2019,Cass,4-Tyler,60,49,11
2019,Castro,1-Lubbock,22,20,2
2019,Chambers,6-Houston,33,29,4
2019,Cherokee,4-Tyler,185,167,18
2019,Childress,1-Lubbock,29,23,6
2019,Clay,2-Abilene,15,12,3
2019,Cochran,1-Lubbock,9,7,2
2019,Coke,9-Midland,7,7,0
2019,Coleman,2-Abilene,28,27,1
2019,Collin,3-Arlington,615,523,92
2019,Collingsworth,1-Lubbock,14,13,1
2019,Colorado,6-Houston,54,50,4
2019,Comal,8-San Antonio,384,334,50
2019,Comanche,2-Abilene,25,24,1
2019,Concho,9-Midland,5,5,0
2019,Cooke,3-Arlington,114,102,12
2019,Coryell,7-Austin,132,116,16
2019,Crane,9-Midland,3,3,0
2019,Crockett,9-Midland,8,8,0
2019,Crosby,1-Lubbock,34,34,0
2019,Culberson,10-El Paso,3,3,0
2019,Dallam,1-Lubbock,24,23,1
2019,Dallas,3-Arlington,3382,3059,323
2019,Dawson,9-Midland,53,49,4
2019,DeWitt,8-San Antonio,65,59,6
2019,Deaf Smith,1-Lubbock,62,60,2
2019,Delta,4-Tyler,14,11,3
2019,Denton,3-Arlington,845,730,115
2019,Dickens,1-Lubbock,5,5,0
2019,Dimmit,8-San Antonio,56,52,4
2019,Donley,1-Lubbock,16,16,0
2019,Duval,11-Edinburg,14,13,1
2019,Eastland,2-Abilene,26,24,2
2019,Ector,9-Midland,419,372,47
2019,Edwards,8-San Antonio,7,7,0
2019,El Paso,10-El Paso,1040,983,57
2019,Ellis,3-Arlington,180,160,20
2019,Erath,3-Arlington,48,46,2
2019,Falls,7-Austin,31,31,0
2019,Fannin,3-Arlington,78,66,12
2019,Fayette,7-Austin,83,71,12
2019,Fisher,2-Abilene,6,5,1
2019,Floyd,1-Lubbock,31,30,1
2019,Foard,2-Abilene,3,3,0
2019,Fort Bend,6-Houston,262,230,32
2019,Franklin,4-Tyler,19,15,4
2019,Freestone,7-Austin,34,30,4
2019,Frio,8-San Antonio,175,151,24
2019,Gaines,9-Midland,26,21,5
2019,Galveston,6-Houston,523,490,33
2019,Garza,1-Lubbock,9,8,1
2019,Gillespie,8-San Antonio,61,47,14
2019,Goliad,8-San Antonio,3,3,0
2019,Gonzales,8-San Antonio,78,74,4
2019,Gray,1-Lubbock,113,100,13
2019,Grayson,3-Arlington,305,269,36
2019,Gregg,4-Tyler,393,341,52
2019,Grimes,7-Austin,46,43,3
2019,Guadalupe,8-San Antonio,299,274,25
2019,Hale,1-Lubbock,117,112,5
2019,Hall,1-Lubbock,10,9,1
2019,Hamilton,7-Austin,15,15,0
2019,Hansford,1-Lubbock,11,11,0
2019,Hardeman,2-Abilene,3,3,0
2019,Hardin,5-Beaumont,66,55,11
2019,Harris,6-Houston,8777,7916,861
2019,Harrison,4-Tyler,110,89,21
2019,Hartley,1-Lubbock,10,9,1
2019,Haskell,2-Abilene,19,19,0
2019,Hays,7-Austin,347,315,32
2019,Hemphill,1-Lubbock,9,9,0
2019,Henderson,4-Tyler,263,219,44
2019,Hidalgo,11-Edinburg,150,150,0
2019,Hill,7-Austin,114,97,17
2019,Hockley,1-Lubbock,128,117,11
2019,Hood,3-Arlington,106,94,12
2019,Hopkins,4-Tyler,127,107,20
2019,Houston,5-Beaumont,58,55,3
2019,Howard,9-Midland,119,112,7
2019,Hudspeth,10-El Paso,1,1,0
2019,Hunt,3-Arlington,454,406,48
2019,Hutchinson,1-Lubbock,52,49,3
2019,Jack,2-Abilene,3,3,0
2019,Jackson,8-San Antonio,35,33,2
2019,Jasper,5-Beaumont,94,90,4
2019,Jefferson,5-Beaumont,614,544,70
2019,Jim Hogg,11-Edinburg,6,6,0
2019,Jim Wells,11-Edinburg,79,71,8
2019,Johnson,3-Arlington,427,392,35
2019,Jones,2-Abilene,15,14,1
2019,Karnes,8-San Antonio,53,53,0
2019,Kaufman,3-Arlington,242,208,34
2019,Kendall,8-San Antonio,63,55,8
2019,Kerr,8-San Antonio,267,221,46
2019,Kimble,9-Midland,19,18,1
2019,Kinney,8-San Antonio,3,3,0
2019,Kleberg,11-Edinburg,86,78,8
2019,Knox,2-Abilene,3,3,0
2019,La Salle,8-San Antonio,34,26,8
2019,Lamar,4-Tyler,74,63,11
2019,Lamb,1-Lubbock,45,43,2
2019,Lampasas,7-Austin,51,45,6
2019,Lavaca,8-San Antonio,40,37,3
2019,Lee,7-Austin,29,26,3
2019,Leon,7-Austin,21,19,2
2019,Liberty,6-Houston,204,178,26
2019,Limestone,7-Austin,58,49,9
2019,Lipscomb,1-Lubbock,7,7,0
2019,Live Oak,11-Edinburg,32,31,1
2019,Llano,7-Austin,81,72,9
2019,Lubbock,1-Lubbock,1668,1534,134
2019,Lynn,1-Lubbock,12,11,1
2019,Madison,7-Austin,23,21,2
2019,Marion,4-Tyler,14,13,1
2019,Martin,9-Midland,2,2,0
2019,Mason,9-Midland,3,3,0
2019,Matagorda,6-Houston,45,41,4
2019,Maverick,8-San Antonio,23,21,2
2019,McCulloch,9-Midland,33,31,2
2019,McLennan,7-Austin,1020,951,69
2019,Medina,8-San Antonio,288,250,38
2019,Menard,9-Midland,7,7,0
2019,Midland,9-Midland,257,229,28
2019,Milam,7-Austin,131,112,19
2019,Mills,7-Austin,11,10,1
2019,Mitchell,2-Abilene,3,1,2
2019,Montague,2-Abilene,49,42,7
2019,Montgomery,6-Houston,979,842,137
2019,Moore,1-Lubbock,25,18,7
2019,Morris,4-Tyler,16,15,1
2019,Motley,1-Lubbock,2,1,1
2019,Nacogdoches,5-Beaumont,211,185,26
2019,Navarro,3-Arlington,168,148,20
2019,Newton,5-Beaumont,23,20,3
2019,Nolan,2-Abilene,35,33,2
2019,None Specified,None Specified,31,29,2
2019,Nueces,11-Edinburg,589,525,64
2019,Ochiltree,1-Lubbock,5,5,0
2019,Oldham,1-Lubbock,1,1,0
2019,Orange,5-Beaumont,214,186,28
2019,Palo Pinto,3-Arlington,159,148,11
2019,Panola,4-Tyler,20,19,1
2019,Parker,3-Arlington,249,234,15
2019,Parmer,1-Lubbock,17,15,2
2019,Pecos,9-Midland,17,15,2
2019,Polk,5-Beaumont,94,79,15
2019,Potter,1-Lubbock,450,422,28
2019,Presidio,10-El Paso,3,3,0
2019,Rains,4-Tyler,34,31,3
2019,Randall,1-Lubbock,430,386,44
2019,Reagan,9-Midland,7,7,0
2019,Real,8-San Antonio,15,13,2
2019,Red River,4-Tyler,26,24,2
2019,Reeves,9-Midland,13,13,0
2019,Refugio,11-Edinburg,2,2,0
2019,Robertson,7-Austin,50,47,3
2019,Rockwall,3-Arlington,57,48,9
2019,Runnels,2-Abilene,25,24,1
2019,Rusk,4-Tyler,66,60,6
2019,Sabine,5-Beaumont,22,18,4
2019,San Augustine,5-Beaumont,8,7,1
2019,San Jacinto,5-Beaumont,22,18,4
2019,San Patricio,11-Edinburg,165,143,22
2019,San Saba,7-Austin,37,34,3
2019,Schleicher,9-Midland,7,6,1
2019,Scurry,2-Abilene,27,25,2
2019,Shackelford,2-Abilene,1,1,0
2019,Shelby,5-Beaumont,51,46,5
2019,Sherman,1-Lubbock,9,6,3
2019,Smith,4-Tyler,548,448,100
2019,Somervell,3-Arlington,14,11,3
2019,Starr,11-Edinburg,22,21,1
2019,Stephens,2-Abilene,11,11,0
2019,Stonewall,2-Abilene,5,5,0
2019,Sutton,9-Midland,9,9,0
2019,Swisher,1-Lubbock,31,29,2
2019,Tarrant,3-Arlington,2705,2432,273
2019,Taylor,2-Abilene,292,268,24
2019,Terry,1-Lubbock,40,35,5
2019,Titus,4-Tyler,61,51,10
2019,Tom Green,9-Midland,576,545,31
2019,Travis,7-Austin,2604,2206,398
2019,Trinity,5-Beaumont,30,27,3
2019,Tyler,5-Beaumont,23,19,4
2019,Upshur,4-Tyler,82,71,11
2019,Upton,9-Midland,5,5,0
2019,Uvalde,8-San Antonio,135,115,20
2019,Val Verde,8-San Antonio,60,56,4
2019,Van Zandt,4-Tyler,189,164,25
2019,Victoria,8-San Antonio,224,194,30
2019,Walker,6-Houston,54,52,2
2019,Waller,6-Houston,86,84,2
2019,Ward,9-Midland,13,13,0
2019,Washington,7-Austin,59,57,2
2019,Webb,11-Edinburg,368,344,24
2019,Wharton,6-Houston,69,61,8
2019,Wheeler,1-Lubbock,9,9,0
2019,Wichita,2-Abilene,321,295,26
2019,Wilbarger,2-Abilene,16,15,1
2019,Willacy,11-Edinburg,43,35,8
2019,Williamson,7-Austin,701,610,91
2019,Wilson,8-San Antonio,116,91,25
2019,Winkler,9-Midland,13,10,3
2019,Wise,3-Arlington,96,89,7
2019,Wood,4-Tyler,124,102,22
2019,Yoakum,1-Lubbock,10,9,1
2019,Young,2-Abilene,47,45,2
2019,Zapata,11-Edinburg,6,6,0
2019,Zavala,8-San Antonio,50,45,5
2018,Anderson,4-Tyler,96,75,21
2018,Andrews,9-Midland,30,28,2
2018,Angelina,5-Beaumont,153,132,21
2018,Aransas,11-Edinburg,79,77,2
2018,Archer,2-Abilene,2,2,0
2018,Armstrong,1-Lubbock,1,1,0
2018,Atascosa,8-San Antonio,344,300,44
2018,Austin,6-Houston,30,28,2
2018,Bailey,1-Lubbock,16,16,0
2018,Bandera,8-San Antonio,94,83,11
2018,Bastrop,7-Austin,315,247,68
2018,Baylor,2-Abilene,4,3,1
2018,Bee,11-Edinburg,71,66,5
2018,Bell,7-Austin,907,736,171
2018,Bexar,8-San Antonio,9598,8343,1255
2018,Blanco,7-Austin,23,20,3
2018,Bosque,7-Austin,54,48,6
2018,Bowie,4-Tyler,167,135,32
2018,Brazoria,6-Houston,250,211,39
2018,Brazos,7-Austin,285,249,36
2018,Brewster,10-El Paso,11,10,1
2018,Brooks,11-Edinburg,14,14,0
2018,Brown,2-Abilene,259,234,25
2018,Burleson,7-Austin,51,47,4
2018,Burnet,7-Austin,210,169,41
2018,Caldwell,7-Austin,172,155,17
2018,Calhoun,8-San Antonio,23,19,4
2018,Callahan,2-Abilene,21,21,0
2018,Cameron,11-Edinburg,211,199,12
2018,Camp,4-Tyler,42,34,8
2018,Carson,1-Lubbock,15,15,0
2018,Cass,4-Tyler,65,53,12
2018,Castro,1-Lubbock,16,14,2
2018,Chambers,6-Houston,30,26,4
2018,Cherokee,4-Tyler,172,153,19
2018,Childress,1-Lubbock,30,24,6
2018,Clay,2-Abilene,15,12,3
2018,Cochran,1-Lubbock,7,5,2
2018,Coke,9-Midland,4,4,0
2018,Coleman,2-Abilene,22,21,1
2018,Collin,3-Arlington,606,496,112
2018,Collingsworth,1-Lubbock,15,13,2
2018,Colorado,6-Houston,57,53,4
2018,Comal,8-San Antonio,357,303,54
2018,Comanche,2-Abilene,29,27,2
2018,Concho,9-Midland,3,3,0
2018,Cooke,3-Arlington,95,81,14
2018,Coryell,7-Austin,122,105,17
2018,Crockett,9-Midland,9,9,0
2018,Crosby,1-Lubbock,38,38,0
2018,Culberson,10-El Paso,3,3,0
2018,Dallam,1-Lubbock,20,19,1
2018,Dallas,3-Arlington,3412,3025,389
2018,Dawson,9-Midland,48,44,4
2018,DeWitt,8-San Antonio,58,52,6
2018,Deaf Smith,1-Lubbock,54,52,2
2018,Delta,4-Tyler,13,10,3
2018,Denton,3-Arlington,820,698,122
2018,Dickens,1-Lubbock,5,5,0
2018,Dimmit,8-San Antonio,62,57,5
2018,Donley,1-Lubbock,11,11,0
2018,Duval,11-Edinburg,14,13,1
2018,Eastland,2-Abilene,25,23,2
2018,Ector,9-Midland,404,354,50
2018,Edwards,8-San Antonio,10,10,0
2018,El Paso,10-El Paso,1028,956,72
2018,Ellis,3-Arlington,169,146,23
2018,Erath,3-Arlington,42,38,4
2018,Falls,7-Austin,29,29,0
2018,Fannin,3-Arlington,75,60,15
2018,Fayette,7-Austin,85,73,12
2018,Fisher,2-Abilene,4,3,1
2018,Floyd,1-Lubbock,28,27,1
2018,Foard,2-Abilene,3,3,0
2018,Fort Bend,6-Houston,261,219,42
2018,Franklin,4-Tyler,16,12,4
2018,Freestone,7-Austin,27,23,4
2018,Frio,8-San Antonio,164,140,24
2018,Gaines,9-Midland,32,26,6
2018,Galveston,6-Houston,499,461,38
2018,Garza,1-Lubbock,9,8,1
2018,Gillespie,8-San Antonio,65,49,16
2018,Goliad,8-San Antonio,4,4,0
2018,Gonzales,8-San Antonio,87,82,5
2018,Gray,1-Lubbock,99,85,14
2018,Grayson,3-Arlington,289,247,42
2018,Gregg,4-Tyler,382,327,55
2018,Grimes,7-Austin,43,39,4
2018,Guadalupe,8-San Antonio,272,247,25
2018,Hale,1-Lubbock,129,124,5
2018,Hall,1-Lubbock,9,8,1
2018,Hamilton,7-Austin,12,12,0
2018,Hansford,1-Lubbock,10,10,0
2018,Hardeman,2-Abilene,3,3,0
2018,Hardin,5-Beaumont,64,52,12
2018,Harris,6-Houston,8568,7620,948
2018,Harrison,4-Tyler,107,84,23
2018,Hartley,1-Lubbock,11,10,1
2018,Haskell,2-Abilene,20,19,1
2018,Hays,7-Austin,317,279,38
2018,Hemphill,1-Lubbock,7,7,0
2018,Henderson,4-Tyler,234,184,50
2018,Hidalgo,11-Edinburg,138,138,0
2018,Hill,7-Austin,101,85,16
2018,Hockley,1-Lubbock,109,95,14
2018,Hood,3-Arlington,107,94,13
2018,Hopkins,4-Tyler,108,85,23
2018,Houston,5-Beaumont,41,38,3
2018,Howard,9-Midland,111,104,7
2018,Hudspeth,10-El Paso,1,1,0
2018,Hunt,3-Arlington,431,382,49
2018,Hutchinson,1-Lubbock,56,53,3
2018,Jack,2-Abilene,1,1,0
2018,Jackson,8-San Antonio,30,28,2
2018,Jasper,5-Beaumont,75,70,5
2018,Jefferson,5-Beaumont,581,502,79
2018,Jim Hogg,11-Edinburg,5,5,0
2018,Jim Wells,11-Edinburg,74,65,9
2018,Johnson,3-Arlington,412,371,41
2018,Jones,2-Abilene,6,5,1
2018,Karnes,8-San Antonio,54,54,0
2018,Kaufman,3-Arlington,214,178,36
2018,Kendall,8-San Antonio,64,55,9
2018,Kerr,8-San Antonio,274,227,47
2018,Kimble,9-Midland,21,20,1
2018,Kinney,8-San Antonio,3,3,0
2018,Kleberg,11-Edinburg,81,70,11
2018,Knox,2-Abilene,3,3,0
2018,La Salle,8-San Antonio,35,27,8
2018,Lamar,4-Tyler,76,64,12
2018,Lamb,1-Lubbock,45,43,2
2018,Lampasas,7-Austin,56,49,7
2018,Lavaca,8-San Antonio,39,35,4
2018,Lee,7-Austin,31,27,4
2018,Leon,7-Austin,20,18,2
2018,Liberty,6-Houston,191,164,27
2018,Limestone,7-Austin,59,48,11
2018,Lipscomb,1-Lubbock,7,7,0
2018,Live Oak,11-Edinburg,27,26,1
2018,Llano,7-Austin,79,70,9
2018,Lubbock,1-Lubbock,1581,1439,143
2018,Lynn,1-Lubbock,10,9,1
2018,Madison,7-Austin,22,19,3
2018,Marion,4-Tyler,14,13,1
2018,Martin,9-Midland,2,2,0
2018,Mason,9-Midland,2,2,0
2018,Matagorda,6-Houston,42,35,7
2018,Maverick,8-San Antonio,28,26,2
2018,McCulloch,9-Midland,30,28,2
2018,McLennan,7-Austin,910,834,76
2018,Medina,8-San Antonio,284,245,39
2018,Menard,9-Midland,7,7,0
2018,Midland,9-Midland,235,204,31
2018,Milam,7-Austin,126,107,19
2018,Mills,7-Austin,12,11,1
2018,Mitchell,2-Abilene,3,1,2
2018,Montague,2-Abilene,39,32,7
2018,Montgomery,6-Houston,930,785,145
2018,Moore,1-Lubbock,24,17,7
2018,Morris,4-Tyler,21,19,2
2018,Motley,1-Lubbock,2,1,1
2018,Nacogdoches,5-Beaumont,209,182,27
2018,Navarro,3-Arlington,166,142,24
2018,Newton,5-Beaumont,23,21,2
2018,Nolan,2-Abilene,28,25,3
2018,None Specified,None Specified,29,27,2
2018,Nueces,11-Edinburg,585,505,80
2018,Oldham,1-Lubbock,1,1,0
2018,Orange,5-Beaumont,188,162,26
2018,Palo Pinto,3-Arlington,132,121,11
2018,Panola,4-Tyler,19,17,2
2018,Parker,3-Arlington,229,212,17
2018,Parmer,1-Lubbock,19,17,2
2018,Pecos,9-Midland,20,18,2
2018,Polk,5-Beaumont,98,81,17
2018,Potter,1-Lubbock,420,385,35
2018,Presidio,10-El Paso,4,4,0
2018,Rains,4-Tyler,27,24,3
2018,Randall,1-Lubbock,418,368,50
2018,Reagan,9-Midland,7,7,0
2018,Real,8-San Antonio,12,10,2
2018,Red River,4-Tyler,23,21,2
2018,Reeves,9-Midland,10,10,0
2018,Refugio,11-Edinburg,4,4,0
2018,Robertson,7-Austin,53,47,6
2018,Rockwall,3-Arlington,56,46,10
2018,Runnels,2-Abilene,24,23,1
2018,Rusk,4-Tyler,60,54,6
2018,Sabine,5-Beaumont,17,13,4
2018,San Augustine,5-Beaumont,10,9,1
2018,San Jacinto,5-Beaumont,27,22,5
2018,San Patricio,11-Edinburg,147,124,23
2018,San Saba,7-Austin,31,28,3
2018,Schleicher,9-Midland,7,6,1
2018,Scurry,2-Abilene,24,22,2
2018,Shackelford,2-Abilene,1,1,0
2018,Shelby,5-Beaumont,52,46,6
2018,Sherman,1-Lubbock,5,2,3
2018,Smith,4-Tyler,528,422,106
2018,Somervell,3-Arlington,12,9,3
2018,Starr,11-Edinburg,22,21,1
2018,Stephens,2-Abilene,8,8,0
2018,Stonewall,2-Abilene,5,5,0
2018,Sutton,9-Midland,10,10,0
2018,Swisher,1-Lubbock,24,21,3
2018,Tarrant,3-Arlington,2614,2316,300
2018,Taylor,2-Abilene,286,260,26
2018,Terry,1-Lubbock,43,38,5
2018,Titus,4-Tyler,63,51,12
2018,Tom Green,9-Midland,572,540,32
2018,Travis,7-Austin,2556,2123,433
2018,Trinity,5-Beaumont,29,25,4
2018,Tyler,5-Beaumont,20,18,2
2018,Upshur,4-Tyler,70,59,11
2018,Upton,9-Midland,5,5,0
2018,Uvalde,8-San Antonio,130,110,20
2018,Val Verde,8-San Antonio,65,59,6
2018,Van Zandt,4-Tyler,176,149,27
2018,Victoria,8-San Antonio,218,186,32
2018,Walker,6-Houston,47,45,2
2018,Waller,6-Houston,77,73,4
2018,Ward,9-Midland,14,14,0
2018,Washington,7-Austin,55,53,3
2018,Webb,11-Edinburg,354,329,25
2018,Wharton,6-Houston,59,50,9
2018,Wheeler,1-Lubbock,10,10,0
2018,Wichita,2-Abilene,302,270,32
2018,Wilbarger,2-Abilene,15,13,2
2018,Willacy,11-Edinburg,39,31,8
2018,Williamson,7-Austin,653,553,100
2018,Wilson,8-San Antonio,115,90,25
2018,Winkler,9-Midland,11,8,3
2018,Wise,3-Arlington,93,84,9
2018,Wood,4-Tyler,127,105,22
2018,Yoakum,1-Lubbock,14,12,2
2018,Young,2-Abilene,38,36,2
2018,Zapata,11-Edinburg,8,8,0
2018,Zavala,8-San Antonio,51,46,5
2017,Anderson,4-Tyler,100,78,22
2017,Andrews,9-Midland,31,29,2
2017,Angelina,5-Beaumont,148,126,22
2017,Aransas,11-Edinburg,74,72,2
2017,Archer,2-Abilene,1,1,0
2017,Armstrong,1-Lubbock,1,1,0
2017,Atascosa,8-San Antonio,331,286,45
2017,Austin,6-Houston,30,28,2
2017,Bailey,1-Lubbock,15,15,0
2017,Bandera,8-San Antonio,95,82,13
2017,Bastrop,7-Austin,296,224,72
2017,Baylor,2-Abilene,3,2,1
2017,Bee,11-Edinburg,65,60,5
2017,Bell,7-Austin,853,675,178
2017,Bexar,8-San Antonio,9451,8110,1342
2017,Blanco,7-Austin,27,24,3
2017,Bosque,7-Austin,50,43,7
2017,Bowie,4-Tyler,167,130,37
2017,Brazoria,6-Houston,264,216,48
2017,Brazos,7-Austin,279,241,38
2017,Brewster,10-El Paso,9,8,1
2017,Brooks,11-Edinburg,15,15,0
2017,Brown,2-Abilene,250,225,25
2017,Burleson,7-Austin,52,45,7
2017,Burnet,7-Austin,199,156,43
2017,Caldwell,7-Austin,173,150,23
2017,Calhoun,8-San Antonio,22,18,4
2017,Callahan,2-Abilene,19,19,0
2017,Cameron,11-Edinburg,183,171,12
2017,Camp,4-Tyler,42,34,8
2017,Carson,1-Lubbock,15,15,0
2017,Cass,4-Tyler,62,50,12
2017,Castro,1-Lubbock,17,14,3
2017,Chambers,6-Houston,30,26,4
2017,Cherokee,4-Tyler,159,139,20
2017,Childress,1-Lubbock,23,17,6
2017,Clay,2-Abilene,16,13,3
2017,Cochran,1-Lubbock,7,5,2
2017,Coke,9-Midland,3,3,0
2017,Coleman,2-Abilene,22,21,1
2017,Collin,3-Arlington,581,459,122
2017,Collingsworth,1-Lubbock,13,11,2
2017,Colorado,6-Houston,49,45,4
2017,Comal,8-San Antonio,314,253,61
2017,Comanche,2-Abilene,25,22,3
2017,Concho,9-Midland,5,5,0
2017,Cooke,3-Arlington,84,70,14
2017,Coryell,7-Austin,124,106,18
2017,Crane,9-Midland,2,2,0
2017,Crockett,9-Midland,8,8,0
2017,Crosby,1-Lubbock,23,23,0
2017,Culberson,10-El Paso,3,3,0
2017,Dallam,1-Lubbock,20,19,1
2017,Dallas,3-Arlington,3432,2972,460
2017,Dawson,9-Midland,53,49,4
2017,DeWitt,8-San Antonio,51,45,6
2017,Deaf Smith,1-Lubbock,65,63,2
2017,Delta,4-Tyler,16,13,3
2017,Denton,3-Arlington,776,643,133
2017,Dickens,1-Lubbock,6,6,0
2017,Dimmit,8-San Antonio,62,57,5
2017,Donley,1-Lubbock,11,11,0
2017,Duval,11-Edinburg,12,11,1
2017,Eastland,2-Abilene,25,23,2
2017,Ector,9-Midland,369,314,55
2017,Edwards,8-San Antonio,9,9,0
2017,El Paso,10-El Paso,1060,979,81
2017,Ellis,3-Arlington,159,134,26
2017,Erath,3-Arlington,47,41,6
2017,Falls,7-Austin,30,30,0
2017,Fannin,3-Arlington,68,52,16
2017,Fayette,7-Austin,82,69,13
2017,Fisher,2-Abilene,3,2,1
2017,Floyd,1-Lubbock,27,26,1
2017,Foard,2-Abilene,3,3,0
2017,Fort Bend,6-Houston,257,211,46
2017,Franklin,4-Tyler,16,12,4
2017,Freestone,7-Austin,26,22,4
2017,Frio,8-San Antonio,142,116,26
2017,Gaines,9-Midland,22,16,6
2017,Galveston,6-Houston,473,430,43
2017,Garza,1-Lubbock,10,9,1
2017,Gillespie,8-San Antonio,61,45,16
2017,Goliad,8-San Antonio,6,6,0
2017,Gonzales,8-San Antonio,84,79,5
2017,Gray,1-Lubbock,104,90,14
2017,Grayson,3-Arlington,266,222,44
2017,Gregg,4-Tyler,371,310,61
2017,Grimes,7-Austin,47,44,3
2017,Guadalupe,8-San Antonio,247,222,25
2017,Hale,1-Lubbock,125,120,5
2017,Hall,1-Lubbock,11,10,1
2017,Hamilton,7-Austin,13,12,1
2017,Hansford,1-Lubbock,9,9,0
2017,Hardeman,2-Abilene,3,3,0
2017,Hardin,5-Beaumont,61,50,11
2017,Harris,6-Houston,8395,7335,1061
2017,Harrison,4-Tyler,110,84,26
2017,Hartley,1-Lubbock,9,8,1
2017,Haskell,2-Abilene,17,16,1
2017,Hays,7-Austin,293,253,40
2017,Hemphill,1-Lubbock,10,10,0
2017,Henderson,4-Tyler,226,174,52
2017,Hidalgo,11-Edinburg,122,121,1
2017,Hill,7-Austin,95,77,18
2017,Hockley,1-Lubbock,96,80,16
2017,Hood,3-Arlington,97,84,13
2017,Hopkins,4-Tyler,99,72,27
2017,Houston,5-Beaumont,33,29,4
2017,Howard,9-Midland,113,105,8
2017,Hudspeth,10-El Paso,1,1,0
2017,Hunt,3-Arlington,401,351,50
2017,Hutchinson,1-Lubbock,46,43,3
2017,Jack,2-Abilene,1,1,0
2017,Jackson,8-San Antonio,28,25,3
2017,Jasper,5-Beaumont,50,45,5
2017,Jefferson,5-Beaumont,552,469,84
2017,Jim Hogg,11-Edinburg,5,5,0
2017,Jim Wells,11-Edinburg,67,58,9
2017,Johnson,3-Arlington,387,342,45
2017,Jones,2-Abilene,8,6,2
2017,Karnes,8-San Antonio,51,51,0
2017,Kaufman,3-Arlington,195,158,37
2017,Kendall,8-San Antonio,60,51,9
2017,Kerr,8-San Antonio,273,225,48
2017,Kimble,9-Midland,20,19,1
2017,Kinney,8-San Antonio,3,3,0
2017,Kleberg,11-Edinburg,80,68,12
2017,Knox,2-Abilene,3,3,0
2017,La Salle,8-San Antonio,37,28,9
2017,Lamar,4-Tyler,64,52,12
2017,Lamb,1-Lubbock,40,36,4
2017,Lampasas,7-Austin,55,47,8
2017,Lavaca,8-San Antonio,32,28,4
2017,Lee,7-Austin,32,28,4
2017,Leon,7-Austin,17,15,2
2017,Liberty,6-Houston,174,142,32
2017,Limestone,7-Austin,55,43,12
2017,Lipscomb,1-Lubbock,7,7,0
2017,Live Oak,11-Edinburg,25,24,1
2017,Llano,7-Austin,80,72,8
2017,Lubbock,1-Lubbock,1426,1272,155
2017,Lynn,1-Lubbock,11,10,1
2017,Madison,7-Austin,21,18,3
2017,Marion,4-Tyler,17,16,1
2017,Mason,9-Midland,4,4,0
2017,Matagorda,6-Houston,44,35,9
2017,Maverick,8-San Antonio,30,27,3
2017,McCulloch,9-Midland,29,27,2
2017,McLennan,7-Austin,863,775,89
2017,Medina,8-San Antonio,271,231,40
2017,Menard,9-Midland,2,2,0
2017,Midland,9-Midland,228,193,35
2017,Milam,7-Austin,115,96,19
2017,Mills,7-Austin,12,10,2
2017,Mitchell,2-Abilene,4,2,2
2017,Montague,2-Abilene,36,27,9
2017,Montgomery,6-Houston,900,750,150
2017,Moore,1-Lubbock,19,12,7
2017,Morris,4-Tyler,15,13,2
2017,Motley,1-Lubbock,2,1,1
2017,Nacogdoches,5-Beaumont,191,163,29
2017,Navarro,3-Arlington,174,147,27
2017,Newton,5-Beaumont,13,13,0
2017,Nolan,2-Abilene,29,26,3
2017,None Specified,None Specified,33,30,3
2017,Nueces,11-Edinburg,593,502,91
2017,Oldham,1-Lubbock,1,1,0
2017,Orange,5-Beaumont,166,139,27
2017,Palo Pinto,3-Arlington,112,101,11
2017,Panola,4-Tyler,12,10,2
2017,Parker,3-Arlington,198,179,21
2017,Parmer,1-Lubbock,14,12,2
2017,Pecos,9-Midland,19,17,2
2017,Polk,5-Beaumont,95,78,17
2017,Potter,1-Lubbock,404,366,38
2017,Presidio,10-El Paso,4,4,0
2017,Rains,4-Tyler,21,18,3
2017,Randall,1-Lubbock,395,342,53
2017,Reagan,9-Midland,8,8,0
2017,Real,8-San Antonio,7,5,2
2017,Red River,4-Tyler,24,22,2
2017,Reeves,9-Midland,11,11,0
2017,Refugio,11-Edinburg,1,1,0
2017,Robertson,7-Austin,52,45,7
2017,Rockwall,3-Arlington,56,46,10
2017,Runnels,2-Abilene,20,19,1
2017,Rusk,4-Tyler,48,42,6
2017,Sabine,5-Beaumont,16,12,4
2017,San Augustine,5-Beaumont,12,11,1
2017,San Jacinto,5-Beaumont,28,23,5
2017,San Patricio,11-Edinburg,135,111,24
2017,San Saba,7-Austin,29,26,3
2017,Schleicher,9-Midland,9,8,1
2017,Scurry,2-Abilene,25,23,2
2017,Shackelford,2-Abilene,1,1,0
2017,Shelby,5-Beaumont,56,50,6
2017,Sherman,1-Lubbock,4,1,3
2017,Smith,4-Tyler,508,391,117
2017,Somervell,3-Arlington,10,7,3
2017,Starr,11-Edinburg,23,22,1
2017,Stephens,2-Abilene,10,10,0
2017,Stonewall,2-Abilene,6,6,0
2017,Sutton,9-Midland,7,7,0
2017,Swisher,1-Lubbock,24,21,3
2017,Tarrant,3-Arlington,2478,2156,322
2017,Taylor,2-Abilene,250,223,27
2017,Terry,1-Lubbock,40,33,7
2017,Titus,4-Tyler,64,51,13
2017,Tom Green,9-Midland,557,522,35
2017,Travis,7-Austin,2478,2019,459
2017,Trinity,5-Beaumont,29,25,4
2017,Tyler,5-Beaumont,18,14,4
2017,Upshur,4-Tyler,60,48,12
2017,Upton,9-Midland,6,6,0
2017,Uvalde,8-San Antonio,115,95,20
2017,Val Verde,8-San Antonio,59,53,6
2017,Van Zandt,4-Tyler,161,134,27
2017,Victoria,8-San Antonio,212,178,34
2017,Walker,6-Houston,45,43,2
2017,Waller,6-Houston,76,71,5
2017,Ward,9-Midland,13,11,2
2017,Washington,7-Austin,57,53,4
2017,Webb,11-Edinburg,349,319,30
2017,Wharton,6-Houston,58,49,9
2017,Wheeler,1-Lubbock,11,11,0
2017,Wichita,2-Abilene,307,268,39
2017,Wilbarger,2-Abilene,18,16,2
2017,Willacy,11-Edinburg,37,31,6
2017,Williamson,7-Austin,617,509,108
2017,Wilson,8-San Antonio,111,86,25
2017,Winkler,9-Midland,10,7,3
2017,Wise,3-Arlington,82,73,9
2017,Wood,4-Tyler,124,102,22
2017,Yoakum,1-Lubbock,11,8,3
2017,Young,2-Abilene,26,24,2
2017,Zapata,11-Edinburg,7,7,0
2017,Zavala,8-San Antonio,52,47,5
2016,Anderson,4-Tyler,97,74,23
2016,Andrews,9-Midland,17,15,2
2016,Angelina,5-Beaumont,115,92,23
2016,Aransas,11-Edinburg,68,66,2
2016,Archer,2-Abilene,1,1,0
2016,Armstrong,1-Lubbock,1,1,0
2016,Atascosa,8-San Antonio,312,268,44
2016,Austin,6-Houston,30,28,2
2016,Bailey,1-Lubbock,15,14,1
2016,Bandera,8-San Antonio,97,84,13
2016,Bastrop,7-Austin,278,205,73
2016,Baylor,2-Abilene,3,2,1
2016,Bee,11-Edinburg,62,56,6
2016,Bell,7-Austin,828,639,189
2016,Bexar,8-San Antonio,9325,7914,1411
2016,Blanco,7-Austin,16,13,3
2016,Bosque,7-Austin,36,29,7
2016,Bowie,4-Tyler,166,126,40
2016,Brazoria,6-Houston,261,210,51
2016,Brazos,7-Austin,282,243,39
2016,Brewster,10-El Paso,10,9,1
2016,Briscoe,1-Lubbock,2,2,0
2016,Brooks,11-Edinburg,17,17,0
2016,Brown,2-Abilene,227,201,26
2016,Burleson,7-Austin,52,42,10
2016,Burnet,7-Austin,181,141,40
2016,Caldwell,7-Austin,166,143,23
2016,Calhoun,8-San Antonio,18,14,4
2016,Callahan,2-Abilene,16,16,0
2016,Cameron,11-Edinburg,174,162,12
2016,Camp,4-Tyler,40,33,7
2016,Carson,1-Lubbock,11,11,0
2016,Cass,4-Tyler,62,51,11
2016,Castro,1-Lubbock,19,15,4
2016,Chambers,6-Houston,33,27,6
2016,Cherokee,4-Tyler,148,127,21
2016,Childress,1-Lubbock,25,18,7
2016,Clay,2-Abilene,18,15,3
2016,Cochran,1-Lubbock,8,5,3
2016,Coke,9-Midland,1,1,0
2016,Coleman,2-Abilene,23,21,2
2016,Collin,3-Arlington,557,425,132
2016,Collingsworth,1-Lubbock,12,10,2
2016,Colorado,6-Houston,49,45,4
2016,Comal,8-San Antonio,287,222,65
2016,Comanche,2-Abilene,24,21,3
2016,Concho,9-Midland,7,7,0
2016,Cooke,3-Arlington,79,63,16
2016,Coryell,7-Austin,104,86,18
2016,Crane,9-Midland,1,1,0
2016,Crockett,9-Midland,4,4,0
2016,Crosby,1-Lubbock,17,17,0
2016,Culberson,10-El Paso,3,3,0
2016,Dallam,1-Lubbock,20,19,1
2016,Dallas,3-Arlington,3381,2872,510
2016,Dawson,9-Midland,49,45,4
2016,DeWitt,8-San Antonio,53,46,7
2016,Deaf Smith,1-Lubbock,56,54,2
2016,Delta,4-Tyler,11,8,3
2016,Denton,3-Arlington,729,594,135
2016,Dickens,1-Lubbock,5,5,0
2016,Dimmit,8-San Antonio,57,52,5
2016,Donley,1-Lubbock,8,8,0
2016,Duval,11-Edinburg,10,9,1
2016,Eastland,2-Abilene,25,23,2
2016,Ector,9-Midland,324,270,55
2016,Edwards,8-San Antonio,8,8,0
2016,El Paso,10-El Paso,1024,933,91
2016,Ellis,3-Arlington,148,121,27
2016,Erath,3-Arlington,49,42,7
2016,Falls,7-Austin,30,30,0
2016,Fannin,3-Arlington,58,42,16
2016,Fayette,7-Austin,70,56,14
2016,Fisher,2-Abilene,4,3,1
2016,Floyd,1-Lubbock,30,29,1
2016,Foard,2-Abilene,3,3,0
2016,Fort Bend,6-Houston,276,220,57
2016,Franklin,4-Tyler,13,11,2
2016,Freestone,7-Austin,31,25,6
2016,Frio,8-San Antonio,143,117,26
2016,Gaines,9-Midland,24,16,8
2016,Galveston,6-Houston,430,379,51
2016,Garza,1-Lubbock,10,9,1
2016,Gillespie,8-San Antonio,53,37,16
2016,Goliad,8-San Antonio,6,6,0
2016,Gonzales,8-San Antonio,74,69,5
2016,Gray,1-Lubbock,109,94,15
2016,Grayson,3-Arlington,267,222,45
2016,Gregg,4-Tyler,368,302,66
2016,Grimes,7-Austin,47,41,6
2016,Guadalupe,8-San Antonio,226,198,28
2016,Hale,1-Lubbock,118,113,5
2016,Hall,1-Lubbock,12,11,1
2016,Hamilton,7-Austin,13,12,1
2016,Hansford,1-Lubbock,6,6,0
2016,Hardeman,2-Abilene,3,3,0
2016,Hardin,5-Beaumont,57,44,13
2016,Harris,6-Houston,8298,7161,1138
2016,Harrison,4-Tyler,110,79,31
2016,Hartley,1-Lubbock,11,10,1
2016,Haskell,2-Abilene,15,13,2
2016,Hays,7-Austin,254,211,43
2016,Hemphill,1-Lubbock,7,7,0
2016,Henderson,4-Tyler,216,169,47
2016,Hidalgo,11-Edinburg,104,103,1
2016,Hill,7-Austin,76,58,18
2016,Hockley,1-Lubbock,94,78,16
2016,Hood,3-Arlington,82,69,13
2016,Hopkins,4-Tyler,82,53,29
2016,Houston,5-Beaumont,29,24,5
2016,Howard,9-Midland,107,98,9
2016,Hudspeth,10-El Paso,1,1,0
2016,Hunt,3-Arlington,365,314,51
2016,Hutchinson,1-Lubbock,37,33,4
2016,Jack,2-Abilene,1,1,0
2016,Jackson,8-San Antonio,28,24,4
2016,Jasper,5-Beaumont,46,40,6
2016,Jefferson,5-Beaumont,529,442,87
2016,Jim Hogg,11-Edinburg,5,5,0
2016,Jim Wells,11-Edinburg,57,47,10
2016,Johnson,3-Arlington,359,310,49
2016,Jones,2-Abilene,10,8,2
2016,Karnes,8-San Antonio,42,42,0
2016,Kaufman,3-Arlington,191,154,37
2016,Kendall,8-San Antonio,56,48,8
2016,Kerr,8-San Antonio,248,201,47
2016,Kimble,9-Midland,20,19,1
2016,Kinney,8-San Antonio,3,3,0
2016,Kleberg,11-Edinburg,80,66,14
2016,Knox,2-Abilene,3,3,0
2016,La Salle,8-San Antonio,38,28,10
2016,Lamar,4-Tyler,50,38,12
2016,Lamb,1-Lubbock,37,34,3
2016,Lampasas,7-Austin,55,47,8
2016,Lavaca,8-San Antonio,29,25,4
2016,Lee,7-Austin,33,28,5
2016,Leon,7-Austin,11,9,2
2016,Liberty,6-Houston,170,134,36
2016,Limestone,7-Austin,60,47,13
2016,Lipscomb,1-Lubbock,7,7,0
2016,Live Oak,11-Edinburg,21,20,1
2016,Llano,7-Austin,75,67,8
2016,Lubbock,1-Lubbock,1306,1144,162
2016,Lynn,1-Lubbock,7,6,1
2016,Madison,7-Austin,22,19,3
2016,Marion,4-Tyler,15,14,1
2016,Mason,9-Midland,2,2,0
2016,Matagorda,6-Houston,43,34,9
2016,Maverick,8-San Antonio,33,30,3
2016,McCulloch,9-Midland,25,23,2
2016,McLennan,7-Austin,808,713,95
2016,Medina,8-San Antonio,252,211,41
2016,Menard,9-Midland,2,2,0
2016,Midland,9-Midland,204,168,36
2016,Milam,7-Austin,105,83,22
2016,Mills,7-Austin,9,7,2
2016,Mitchell,2-Abilene,3,0,3
2016,Montague,2-Abilene,39,30,9
2016,Montgomery,6-Houston,859,698,161
2016,Moore,1-Lubbock,17,12,5
2016,Morris,4-Tyler,14,12,2
2016,Motley,1-Lubbock,2,1,1
2016,Nacogdoches,5-Beaumont,174,144,30
2016,Navarro,3-Arlington,185,155,30
2016,Newton,5-Beaumont,11,11,0
2016,Nolan,2-Abilene,27,24,3
2016,None Specified,None Specified,39,36,3
2016,Nueces,11-Edinburg,605,498,107
2016,Oldham,1-Lubbock,1,1,0
2016,Orange,5-Beaumont,145,118,27
2016,Palo Pinto,3-Arlington,100,89,11
2016,Panola,4-Tyler,11,9,2
2016,Parker,3-Arlington,166,143,23
2016,Parmer,1-Lubbock,15,12,3
2016,Pecos,9-Midland,17,15,2
2016,Polk,5-Beaumont,99,82,17
2016,Potter,1-Lubbock,390,351,39
2016,Presidio,10-El Paso,5,5,0
2016,Rains,4-Tyler,22,18,4
2016,Randall,1-Lubbock,377,324,53
2016,Reagan,9-Midland,9,9,0
2016,Real,8-San Antonio,4,2,2
2016,Red River,4-Tyler,16,14,2
2016,Reeves,9-Midland,8,7,1
2016,Refugio,11-Edinburg,2,2,0
2016,Robertson,7-Austin,57,47,10
2016,Rockwall,3-Arlington,50,39,11
2016,Runnels,2-Abilene,20,18,2
2016,Rusk,4-Tyler,44,38,6
2016,Sabine,5-Beaumont,13,10,3
2016,San Augustine,5-Beaumont,12,12,0
2016,San Jacinto,5-Beaumont,25,19,6
2016,San Patricio,11-Edinburg,131,106,25
2016,San Saba,7-Austin,28,23,5
2016,Schleicher,9-Midland,7,6,1
2016,Scurry,2-Abilene,26,24,2
2016,Shackelford,2-Abilene,1,1,0
2016,Shelby,5-Beaumont,64,56,8
2016,Sherman,1-Lubbock,4,1,3
2016,Smith,4-Tyler,474,353,121
2016,Somervell,3-Arlington,8,5,3
2016,Starr,11-Edinburg,17,16,1
2016,Stephens,2-Abilene,12,12,0
2016,Stonewall,2-Abilene,6,6,0
2016,Sutton,9-Midland,7,7,0
2016,Swisher,1-Lubbock,22,19,3
2016,Tarrant,3-Arlington,2304,1965,339
2016,Taylor,2-Abilene,227,198,29
2016,Terry,1-Lubbock,42,34,8
2016,Titus,4-Tyler,56,43,13
2016,Tom Green,9-Midland,514,481,33
2016,Travis,7-Austin,2346,1862,484
2016,Trinity,5-Beaumont,24,19,5
2016,Tyler,5-Beaumont,11,7,4
2016,Upshur,4-Tyler,58,46,12
2016,Upton,9-Midland,5,5,0
2016,Uvalde,8-San Antonio,109,90,19
2016,Val Verde,8-San Antonio,62,56,6
2016,Van Zandt,4-Tyler,161,135,26
2016,Victoria,8-San Antonio,197,162,35
2016,Walker,6-Houston,40,38,2
2016,Waller,6-Houston,77,72,5
2016,Ward,9-Midland,14,12,2
2016,Washington,7-Austin,60,55,5
2016,Webb,11-Edinburg,337,303,34
2016,Wharton,6-Houston,56,45,11
2016,Wheeler,1-Lubbock,11,10,1
2016,Wichita,2-Abilene,302,253,49
2016,Wilbarger,2-Abilene,21,16,5
2016,Willacy,11-Edinburg,37,32,5
2016,Williamson,7-Austin,584,471,113
2016,Wilson,8-San Antonio,88,63,25
2016,Winkler,9-Midland,10,7,3
2016,Wise,3-Arlington,76,64,12
2016,Wood,4-Tyler,116,94,22
2016,Yoakum,1-Lubbock,13,9,4
2016,Young,2-Abilene,18,16,2
2016,Zapata,11-Edinburg,11,11,0
2016,Zavala,8-San Antonio,50,45,5
2015,Anderson,4-Tyler,78,56,22
2015,Andrews,9-Midland,19,16,3
2015,Angelina,5-Beaumont,115,89,26
2015,Aransas,11-Edinburg,58,56,2
2015,Archer,2-Abilene,1,1,0
2015,Armstrong,1-Lubbock,3,3,0
2015,Atascosa,8-San Antonio,288,246,42
2015,Austin,6-Houston,29,27,2
2015,Bailey,1-Lubbock,14,14,0
2015,Bandera,8-San Antonio,103,90,13
2015,Bastrop,7-Austin,238,162,76
2015,Baylor,2-Abilene,3,2,1
2015,Bee,11-Edinburg,51,45,6
2015,Bell,7-Austin,787,599,188
2015,Bexar,8-San Antonio,8942,7527,1415
2015,Blanco,7-Austin,15,14,1
2015,Borden,9-Midland,5,5,0
2015,Bosque,7-Austin,34,27,7
2015,Bowie,4-Tyler,174,131,43
2015,Brazoria,6-Houston,257,203,54
2015,Brazos,7-Austin,279,239,40
2015,Brewster,10-El Paso,11,9,2
2015,Brooks,11-Edinburg,16,16,0
2015,Brown,2-Abilene,221,197,24
2015,Burleson,7-Austin,53,44,9
2015,Burnet,7-Austin,166,126,40
2015,Caldwell,7-Austin,172,147,25
2015,Calhoun,8-San Antonio,20,16,4
2015,Callahan,2-Abilene,18,18,0
2015,Cameron,11-Edinburg,159,150,9
2015,Camp,4-Tyler,38,31,7
2015,Carson,1-Lubbock,9,9,0
2015,Cass,4-Tyler,55,46,9
2015,Castro,1-Lubbock,17,13,4
2015,Chambers,6-Houston,30,24,6
2015,Cherokee,4-Tyler,123,105,18
2015,Childress,1-Lubbock,29,21,8
2015,Clay,2-Abilene,18,15,3
2015,Cochran,1-Lubbock,6,3,3
2015,Coke,9-Midland,1,1,0
2015,Coleman,2-Abilene,24,22,2
2015,Collin,3-Arlington,534,400,134
2015,Collingsworth,1-Lubbock,12,10,2
2015,Colorado,6-Houston,53,48,5
2015,Comal,8-San Antonio,255,188,67
2015,Comanche,2-Abilene,23,19,4
2015,Concho,9-Midland,7,6,1
2015,Cooke,3-Arlington,74,57,17
2015,Coryell,7-Austin,94,77,17
2015,Crane,9-Midland,1,1,0
2015,Crockett,9-Midland,4,4,0
2015,Crosby,1-Lubbock,20,20,0
2015,Culberson,10-El Paso,3,3,0
2015,Dallam,1-Lubbock,18,17,1
2015,Dallas,3-Arlington,3342,2811,531
2015,Dawson,9-Midland,30,29,1
2015,DeWitt,8-San Antonio,43,37,6
2015,Deaf Smith,1-Lubbock,41,40,1
2015,Delta,4-Tyler,8,7,1
2015,Denton,3-Arlington,667,527,140
2015,Dickens,1-Lubbock,3,3,0
2015,Dimmit,8-San Antonio,49,44,5
2015,Donley,1-Lubbock,4,4,0
2015,Duval,11-Edinburg,6,5,1
2015,Eastland,2-Abilene,25,22,3
2015,Ector,9-Midland,293,233,60
2015,Edwards,8-San Antonio,7,7,0
2015,El Paso,10-El Paso,962,863,99
2015,Ellis,3-Arlington,149,122,27
2015,Erath,3-Arlington,47,40,7
2015,Falls,7-Austin,29,29,0
2015,Fannin,3-Arlington,59,43,16
2015,Fayette,7-Austin,72,56,16
2015,Fisher,2-Abilene,5,4,1
2015,Floyd,1-Lubbock,30,29,1
2015,Foard,2-Abilene,3,3,0
2015,Fort Bend,6-Houston,293,233,60
2015,Franklin,4-Tyler,15,13,2
2015,Freestone,7-Austin,33,26,7
2015,Frio,8-San Antonio,128,101,27
2015,Gaines,9-Midland,22,16,6
2015,Galveston,6-Houston,398,346,52
2015,Garza,1-Lubbock,11,10,1
2015,Gillespie,8-San Antonio,54,38,16
2015,Goliad,8-San Antonio,5,5,0
2015,Gonzales,8-San Antonio,75,72,3
2015,Gray,1-Lubbock,104,89,15
2015,Grayson,3-Arlington,259,215,44
2015,Gregg,4-Tyler,341,279,62
2015,Grimes,7-Austin,39,36,3
2015,Guadalupe,8-San Antonio,227,198,29
2015,Hale,1-Lubbock,104,99,5
2015,Hall,1-Lubbock,7,6,1
2015,Hamilton,7-Austin,14,12,2
2015,Hansford,1-Lubbock,2,1,1
2015,Hardeman,2-Abilene,3,3,0
2015,Hardin,5-Beaumont,54,42,12
2015,Harris,6-Houston,8076,6881,1196
2015,Harrison,4-Tyler,101,71,30
2015,Hartley,1-Lubbock,11,10,1
2015,Haskell,2-Abilene,15,13,2
2015,Hays,7-Austin,236,190,46
2015,Hemphill,1-Lubbock,5,5,0
2015,Henderson,4-Tyler,182,136,46
2015,Hidalgo,11-Edinburg,77,75,2
2015,Hill,7-Austin,66,48,18
2015,Hockley,1-Lubbock,79,65,14
2015,Hood,3-Arlington,68,55,13
2015,Hopkins,4-Tyler,76,49,27
2015,Houston,5-Beaumont,31,26,5
2015,Howard,9-Midland,91,81,10
2015,Hudspeth,10-El Paso,1,1,0
2015,Hunt,3-Arlington,324,277,47
2015,Hutchinson,1-Lubbock,31,27,4
2015,Jack,2-Abilene,2,2,0
2015,Jackson,8-San Antonio,22,18,4
2015,Jasper,5-Beaumont,44,39,5
2015,Jefferson,5-Beaumont,500,409,91
2015,Jim Hogg,11-Edinburg,5,5,0
2015,Jim Wells,11-Edinburg,51,42,9
2015,Johnson,3-Arlington,343,292,51
2015,Jones,2-Abilene,12,10,2
2015,Karnes,8-San Antonio,25,25,0
2015,Kaufman,3-Arlington,164,127,37
2015,Kendall,8-San Antonio,49,41,8
2015,Kerr,8-San Antonio,225,181,44
2015,Kimble,9-Midland,21,20,1
2015,Kinney,8-San Antonio,3,3,0
2015,Kleberg,11-Edinburg,86,71,15
2015,Knox,2-Abilene,3,3,0
2015,La Salle,8-San Antonio,41,31,10
2015,Lamar,4-Tyler,46,33,13
2015,Lamb,1-Lubbock,27,24,3
2015,Lampasas,7-Austin,45,37,8
2015,Lavaca,8-San Antonio,27,24,3
2015,Lee,7-Austin,29,24,5
2015,Leon,7-Austin,12,9,3
2015,Liberty,6-Houston,165,127,38
2015,Limestone,7-Austin,59,45,14
2015,Lipscomb,1-Lubbock,7,7,0
2015,Live Oak,11-Edinburg,18,17,1
2015,Llano,7-Austin,71,62,9
2015,Lubbock,1-Lubbock,1175,1018,157
2015,Lynn,1-Lubbock,5,4,1
2015,Madison,7-Austin,22,18,4
2015,Marion,4-Tyler,15,14,1
2015,Mason,9-Midland,2,2,0
2015,Matagorda,6-Houston,47,36,11
2015,Maverick,8-San Antonio,35,32,3
2015,McCulloch,9-Midland,20,18,2
2015,McLennan,7-Austin,693,592,101
2015,Medina,8-San Antonio,231,191,40
2015,Menard,9-Midland,2,2,0
2015,Midland,9-Midland,194,155,39
2015,Milam,7-Austin,105,85,20
2015,Mills,7-Austin,9,7,2
2015,Mitchell,2-Abilene,4,1,3
2015,Montague,2-Abilene,38,29,9
2015,Montgomery,6-Houston,830,667,163
2015,Moore,1-Lubbock,18,12,6
2015,Morris,4-Tyler,12,10,2
2015,Motley,1-Lubbock,2,1,1
2015,Nacogdoches,5-Beaumont,154,124,30
2015,Navarro,3-Arlington,185,155,30
2015,Newton,5-Beaumont,12,12,0
2015,Nolan,2-Abilene,26,23,3
2015,None Specified,None Specified,44,41,3
2015,Nueces,11-Edinburg,599,486,113
2015,Oldham,1-Lubbock,1,1,0
2015,Orange,5-Beaumont,129,102,27
2015,Palo Pinto,3-Arlington,95,86,9
2015,Panola,4-Tyler,13,11,2
2015,Parker,3-Arlington,124,103,21
2015,Parmer,1-Lubbock,15,12,3
2015,Pecos,9-Midland,15,13,2
2015,Polk,5-Beaumont,103,81,22
2015,Potter,1-Lubbock,347,309,38
2015,Presidio,10-El Paso,6,6,0
2015,Rains,4-Tyler,11,8,3
2015,Randall,1-Lubbock,354,298,56
2015,Reagan,9-Midland,7,7,0
2015,Real,8-San Antonio,5,3,2
2015,Red River,4-Tyler,14,11,3
2015,Reeves,9-Midland,7,6,1
2015,Refugio,11-Edinburg,2,2,0
2015,Robertson,7-Austin,59,49,10
2015,Rockwall,3-Arlington,52,38,14
2015,Runnels,2-Abilene,19,17,2
2015,Rusk,4-Tyler,41,33,8
2015,Sabine,5-Beaumont,12,9,3
2015,San Augustine,5-Beaumont,12,12,0
2015,San Jacinto,5-Beaumont,27,19,8
2015,San Patricio,11-Edinburg,115,90,25
2015,San Saba,7-Austin,21,19,2
2015,Schleicher,9-Midland,8,6,2
2015,Scurry,2-Abilene,27,24,3
2015,Shackelford,2-Abilene,1,1,0
2015,Shelby,5-Beaumont,66,57,9
2015,Sherman,1-Lubbock,4,1,3
2015,Smith,4-Tyler,442,321,121
2015,Somervell,3-Arlington,8,5,3
2015,Starr,11-Edinburg,13,12,1
2015,Stephens,2-Abilene,9,9,0
2015,Stonewall,2-Abilene,1,1,0
2015,Sutton,9-Midland,9,8,1
2015,Swisher,1-Lubbock,23,21,2
2015,Tarrant,3-Arlington,2214,1878,336
2015,Taylor,2-Abilene,199,169,30
2015,Terry,1-Lubbock,35,27,8
2015,Titus,4-Tyler,58,43,15
2015,Tom Green,9-Midland,464,429,36
2015,Travis,7-Austin,2262,1791,471
2015,Trinity,5-Beaumont,23,18,5
2015,Tyler,5-Beaumont,13,9,4
2015,Upshur,4-Tyler,50,39,11
2015,Uvalde,8-San Antonio,103,86,17
2015,Val Verde,8-San Antonio,56,50,6
2015,Van Zandt,4-Tyler,138,117,21
2015,Victoria,8-San Antonio,176,146,30
2015,Walker,6-Houston,34,32,2
2015,Waller,6-Houston,77,72,5
2015,Ward,9-Midland,12,10,2
2015,Washington,7-Austin,53,48,5
2015,Webb,11-Edinburg,300,265,35
2015,Wharton,6-Houston,57,46,11
2015,Wheeler,1-Lubbock,9,7,2
2015,Wichita,2-Abilene,298,239,59
2015,Wilbarger,2-Abilene,22,16,6
2015,Willacy,11-Edinburg,32,27,5
2015,Williamson,7-Austin,537,418,119
2015,Wilson,8-San Antonio,77,53,24
2015,Winkler,9-Midland,10,7,3
2015,Wise,3-Arlington,71,59,12
2015,Wood,4-Tyler,96,74,22
2015,Yoakum,1-Lubbock,12,8,4
2015,Young,2-Abilene,20,17,3
2015,Zapata,11-Edinburg,14,14,0
2015,Zavala,8-San Antonio,42,39,3
2014,Anderson,4-Tyler,72,50,22
2014,Andrews,9-Midland,18,16,2
2014,Angelina,5-Beaumont,120,89,35
2014,Aransas,11-Edinburg,53,51,2
2014,Archer,2-Abilene,1,1,0
2014,Armstrong,1-Lubbock,1,1,0
2014,Atascosa,8-San Antonio,255,219,36
2014,Austin,6-Houston,29,26,3
2014,Bailey,1-Lubbock,11,11,0
2014,Bandera,8-San Antonio,88,73,15
2014,Bastrop,7-Austin,197,131,66
2014,Baylor,2-Abilene,3,2,1
2014,Bee,11-Edinburg,49,43,6
2014,Bell,7-Austin,761,579,182
2014,Bexar,8-San Antonio,8350,6967,1383
2014,Blanco,7-Austin,15,14,1
2014,Bosque,7-Austin,28,20,8
2014,Bowie,4-Tyler,165,120,45
2014,Brazoria,6-Houston,261,204,57
2014,Brazos,7-Austin,266,222,44
2014,Brewster,10-El Paso,11,9,2
2014,Brooks,11-Edinburg,16,16,0
2014,Brown,2-Abilene,207,184,23
2014,Burleson,7-Austin,49,41,8
2014,Burnet,7-Austin,159,121,38
2014,Caldwell,7-Austin,158,133,25
2014,Calhoun,8-San Antonio,19,15,4
2014,Callahan,2-Abilene,14,14,0
2014,Cameron,11-Edinburg,149,140,9
2014,Camp,4-Tyler,29,22,7
2014,Carson,1-Lubbock,9,9,0
2014,Cass,4-Tyler,54,45,9
2014,Castro,1-Lubbock,13,9,4
2014,Chambers,6-Houston,26,20,6
2014,Cherokee,4-Tyler,96,81,15
2014,Childress,1-Lubbock,27,19,8
2014,Clay,2-Abilene,21,17,4
2014,Cochran,1-Lubbock,6,3,3
2014,Coke,9-Midland,2,2,0
2014,Coleman,2-Abilene,24,22,2
2014,Collin,3-Arlington,503,367,136
2014,Collingsworth,1-Lubbock,11,9,2
2014,Colorado,6-Houston,56,51,5
2014,Comal,8-San Antonio,221,153,68
2014,Comanche,2-Abilene,20,16,4
2014,Concho,9-Midland,9,7,2
2014,Cooke,3-Arlington,68,50,18
2014,Coryell,7-Austin,96,76,20
2014,Crane,9-Midland,1,1,0
2014,Crockett,9-Midland,5,5,0
2014,Crosby,1-Lubbock,15,15,0
2014,Culberson,10-El Paso,2,2,0
2014,Dallam,1-Lubbock,17,16,1
2014,Dallas,3-Arlington,3284,2731,553
2014,Dawson,9-Midland,25,24,1
2014,DeWitt,8-San Antonio,44,38,6
2014,Deaf Smith,1-Lubbock,45,44,1
2014,Delta,4-Tyler,6,6,0
2014,Denton,3-Arlington,615,476,139
2014,Dickens,1-Lubbock,2,2,0
2014,Dimmit,8-San Antonio,45,40,5
2014,Donley,1-Lubbock,4,4,0
2014,Duval,11-Edinburg,4,3,1
2014,Eastland,2-Abilene,25,22,3
2014,Ector,9-Midland,229,181,48
2014,Edwards,8-San Antonio,7,7,0
2014,El Paso,10-El Paso,933,826,107
2014,Ellis,3-Arlington,148,119,29
2014,Erath,3-Arlington,52,44,8
2014,Falls,7-Austin,24,24,0
2014,Fannin,3-Arlington,53,35,18
2014,Fayette,7-Austin,61,45,16
2014,Fisher,2-Abilene,5,4,1
2014,Floyd,1-Lubbock,22,20,2
2014,Foard,2-Abilene,3,3,0
2014,Fort Bend,6-Houston,297,231,66
2014,Franklin,4-Tyler,12,12,0
2014,Freestone,7-Austin,32,24,8
2014,Frio,8-San Antonio,104,79,25
2014,Gaines,9-Midland,20,14,6
2014,Galveston,6-Houston,383,329,54
2014,Garza,1-Lubbock,7,5,2
2014,Gillespie,8-San Antonio,53,38,15
2014,Goliad,8-San Antonio,2,2,0
2014,Gonzales,8-San Antonio,67,65,2
2014,Gray,1-Lubbock,106,91,15
2014,Grayson,3-Arlington,238,195,43
2014,Gregg,4-Tyler,331,265,66
2014,Grimes,7-Austin,40,37,3
2014,Guadalupe,8-San Antonio,202,179,23
2014,Hale,1-Lubbock,99,93,6
2014,Hall,1-Lubbock,7,6,1
2014,Hamilton,7-Austin,14,12,2
2014,Hansford,1-Lubbock,2,1,1
2014,Hardeman,2-Abilene,4,4,0
2014,Hardin,5-Beaumont,49,34,20
2014,Harris,6-Houston,7670,6478,1192
2014,Harrison,4-Tyler,90,59,31
2014,Hartley,1-Lubbock,8,7,1
2014,Haskell,2-Abilene,13,9,4
2014,Hays,7-Austin,207,168,39
2014,Hemphill,1-Lubbock,3,3,0
2014,Henderson,4-Tyler,168,129,39
2014,Hidalgo,11-Edinburg,73,70,3
2014,Hill,7-Austin,54,36,18
2014,Hockley,1-Lubbock,77,61,16
2014,Hood,3-Arlington,51,37,14
2014,Hopkins,4-Tyler,72,46,26
2014,Houston,5-Beaumont,29,23,7
2014,Howard,9-Midland,63,53,10
2014,Hudspeth,10-El Paso,1,1,0
2014,Hunt,3-Arlington,297,251,47
2014,Hutchinson,1-Lubbock,29,25,4
2014,Jack,2-Abilene,3,3,0
2014,Jackson,8-San Antonio,21,18,3
2014,Jasper,5-Beaumont,47,40,11
2014,Jefferson,5-Beaumont,487,393,130
2014,Jim Hogg,11-Edinburg,5,5,0
2014,Jim Wells,11-Edinburg,47,39,8
2014,Johnson,3-Arlington,322,274,48
2014,Jones,2-Abilene,11,9,2
2014,Karnes,8-San Antonio,19,19,0
2014,Kaufman,3-Arlington,151,117,34
2014,Kendall,8-San Antonio,44,36,8
2014,Kent,2-Abilene,4,4,0
2014,Kerr,8-San Antonio,218,174,44
2014,Kimble,9-Midland,22,21,1
2014,Kinney,8-San Antonio,3,3,0
2014,Kleberg,11-Edinburg,87,70,17
2014,Knox,2-Abilene,3,3,0
2014,La Salle,8-San Antonio,38,28,10
2014,Lamar,4-Tyler,52,37,15
2014,Lamb,1-Lubbock,33,29,4
2014,Lampasas,7-Austin,46,39,7
2014,Lavaca,8-San Antonio,20,18,2
2014,Lee,7-Austin,28,22,6
2014,Leon,7-Austin,14,10,4
2014,Liberty,6-Houston,150,116,34
2014,Limestone,7-Austin,53,41,12
2014,Lipscomb,1-Lubbock,6,6,0
2014,Live Oak,11-Edinburg,13,12,1
2014,Llano,7-Austin,65,56,9
2014,Lubbock,1-Lubbock,1120,958,162
2014,Lynn,1-Lubbock,4,3,1
2014,Madison,7-Austin,21,17,4
2014,Marion,4-Tyler,10,9,1
2014,Mason,9-Midland,2,2,0
2014,Matagorda,6-Houston,41,30,11
2014,Maverick,8-San Antonio,40,35,5
2014,McCulloch,9-Midland,19,17,2
2014,McLennan,7-Austin,630,526,104
2014,Medina,8-San Antonio,200,165,35
2014,Menard,9-Midland,2,2,0
2014,Midland,9-Midland,186,151,35
2014,Milam,7-Austin,109,86,23
2014,Mills,7-Austin,9,7,2
2014,Mitchell,2-Abilene,5,2,3
2014,Montague,2-Abilene,38,27,11
2014,Montgomery,6-Houston,786,624,162
2014,Moore,1-Lubbock,15,9,6
2014,Morris,4-Tyler,11,10,1
2014,Motley,1-Lubbock,1,0,1
2014,Nacogdoches,5-Beaumont,143,111,47
2014,Navarro,3-Arlington,178,146,32
2014,Newton,5-Beaumont,13,13,0
2014,Nolan,2-Abilene,25,22,3
2014,None Specified,None Specified,53,49,4
2014,Nueces,11-Edinburg,630,511,119
2014,Oldham,1-Lubbock,2,1,1
2014,Orange,5-Beaumont,109,85,33
2014,Palo Pinto,3-Arlington,63,55,8
2014,Panola,4-Tyler,11,9,2
2014,Parker,3-Arlington,105,85,20
2014,Parmer,1-Lubbock,16,13,3
2014,Pecos,9-Midland,14,13,1
2014,Polk,5-Beaumont,98,79,23
2014,Potter,1-Lubbock,307,270,37
2014,Presidio,10-El Paso,4,4,0
2014,Rains,4-Tyler,11,8,3
2014,Randall,1-Lubbock,331,275,56
2014,Reagan,9-Midland,7,7,0
2014,Real,8-San Antonio,3,3,0
2014,Red River,4-Tyler,15,12,3
2014,Reeves,9-Midland,8,7,1
2014,Refugio,11-Edinburg,3,3,0
2014,Robertson,7-Austin,57,47,10
2014,Rockwall,3-Arlington,52,38,14
2014,Runnels,2-Abilene,19,17,2
2014,Rusk,4-Tyler,36,29,7
2014,Sabine,5-Beaumont,11,8,3
2014,San Augustine,5-Beaumont,13,13,2
2014,San Jacinto,5-Beaumont,23,15,8
2014,San Patricio,11-Edinburg,107,83,24
2014,San Saba,7-Austin,21,19,2
2014,Schleicher,9-Midland,4,2,2
2014,Scurry,2-Abilene,29,26,3
2014,Shackelford,2-Abilene,1,1,0
2014,Shelby,5-Beaumont,63,56,8
2014,Sherman,1-Lubbock,5,1,4
2014,Smith,4-Tyler,403,288,115
2014,Somervell,3-Arlington,7,5,2
2014,Starr,11-Edinburg,16,16,0
2014,Stephens,2-Abilene,7,7,0
2014,Stonewall,2-Abilene,2,2,0
2014,Sutton,9-Midland,8,8,0
2014,Swisher,1-Lubbock,21,19,2
2014,Tarrant,3-Arlington,2077,1730,347
2014,Taylor,2-Abilene,186,157,29
2014,Terry,1-Lubbock,40,31,9
2014,Titus,4-Tyler,50,35,15
2014,Tom Green,9-Midland,419,380,40
2014,Travis,7-Austin,2150,1690,462
2014,Trinity,5-Beaumont,21,16,5
2014,Tyler,5-Beaumont,15,11,4
2014,Upshur,4-Tyler,49,38,11
2014,Uvalde,8-San Antonio,95,78,17
2014,Val Verde,8-San Antonio,57,51,6
2014,Van Zandt,4-Tyler,130,111,19
2014,Victoria,8-San Antonio,170,136,34
2014,Walker,6-Houston,29,27,2
2014,Waller,6-Houston,82,74,8
2014,Ward,9-Midland,12,10,2
2014,Washington,7-Austin,57,51,6
2014,Webb,11-Edinburg,282,252,30
2014,Wharton,6-Houston,58,47,11
2014,Wheeler,1-Lubbock,10,7,3
2014,Wichita,2-Abilene,302,234,68
2014,Wilbarger,2-Abilene,22,16,6
2014,Willacy,11-Edinburg,30,27,3
2014,Williamson,7-Austin,504,386,118
2014,Wilson,8-San Antonio,64,44,20
2014,Winkler,9-Midland,10,6,4
2014,Wise,3-Arlington,62,49,13
2014,Wood,4-Tyler,87,62,25
2014,Yoakum,1-Lubbock,12,8,4
2014,Young,2-Abilene,19,16,3
2014,Zapata,11-Edinburg,12,12,0
2014,Zavala,8-San Antonio,37,35,2
